year,field,germans_male,germans_female,germans_total,foreigners_male,foreigners_female,foreigners_total,total_male,total_female,general_total
2013,Waste Management,64,32,96,9,4,13,73,36,109
2013,African Studies,384,783,1167,185,178,363,569,961,1530
2013,Agricultural Biology,155,264,419,97,87,184,252,351,603
2013,Agricultural Economics,728,548,1276,208,173,381,936,721,1657
2013,Agricultural Science/Agriculture,7836,7238,15074,981,773,1754,8817,8011,16828
2013,Egyptology,133,336,469,23,43,66,156,379,535
2013,General Linguistics/Indo-European Studies,1278,3976,5254,261,854,1115,1539,4830,6369
2013,General Literary Studies,874,2964,3838,165,526,691,1039,3490,4529
2013,Ancient History,177,132,309,21,15,36,198,147,345
2013,American Studies,914,2060,2974,170,465,635,1084,2525,3609
2013,Applied Art,1366,2158,3524,204,299,503,1570,2457,4027
2013,Applied Linguistics,866,3781,4647,252,889,1141,1118,4670,5788
2013,Applied Systems Science,1568,307,1875,371,127,498,1939,434,2373
2013,English Studies,12222,30784,43006,983,3277,4260,13205,34061,47266
2013,Anthropology (Human Biology),265,565,830,70,107,177,335,672,1007
2013,Arabic/Arabic Studies,209,334,543,73,51,124,282,385,667
2013,Work Studies/Business Studies,825,1197,2022,23,49,72,848,1246,2094
2013,Occupational Guidance and Career Counselling,33,136,169,,1,1,33,137,170
2013,Labour Administration,194,490,684,2,4,6,196,494,690
2013,Archaeology,2304,2853,5157,178,286,464,2482,3139,5621
2013,Archaeometry (Archaeological Engineering),23,15,38,,,,23,15,38
2013,Architecture,13096,15681,28777,2811,3851,6662,15907,19532,35439
2013,Archive and Documentation Science,121,204,325,13,30,43,134,234,368
2013,Archive Studies,122,146,268,3,5,8,125,151,276
2013,Asian Languages and Cultures/Asian Studies,651,1135,1786,136,294,430,787,1429,2216
2013,Astrophysics and Astronomy,210,58,268,115,70,185,325,128,453
2013,Ophthalmic Optics,214,552,766,23,29,52,237,581,818
2013,Immigrant Education,16,122,138,23,52,75,39,174,213
2013,Non-Europ. Lang. and Cult. in Oceania and America,99,160,259,29,58,87,128,218,346
2013,Foreign Affairs Administration,56,92,148,,,,56,92,148
2013,Baltic Studies,7,5,12,,2,2,7,7,14
2013,Banking,354,244,598,2,2,4,356,246,602
2013,Civil Engineering/Structural Engineering,31907,11962,43869,5649,2209,7858,37556,14171,51727
2013,Mining/Mine Engineering,1241,179,1420,301,78,379,1542,257,1799
2013,Occupation-specific Foreign Language Training,447,1239,1686,78,229,307,525,1468,1993
2013,"Vocational, Business and Economics Education",648,693,1341,65,87,152,713,780,1493
2013,Business Administration,105306,94853,200159,9677,12758,22435,114983,107611,222594
2013,Librarianship,13,20,33,,,,13,20,33
2013,Fine Arts/Graphics,1245,1540,2785,341,599,940,1586,2139,3725
2013,Sculpting/Statuary Art,172,201,373,57,103,160,229,304,533
2013,Biochemistry,3123,3760,6883,380,423,803,3503,4183,7686
2013,Bioinformatics,1137,584,1721,194,147,341,1331,731,2062
2013,Biology,16839,29749,46588,2219,3250,5469,19058,32999,52057
2013,Biomedicine,477,820,1297,157,216,373,634,1036,1670
2013,Biotechnology,4762,5462,10224,534,567,1101,5296,6029,11325
2013,Ed.of Blind a.Visually Imp.(cl.w.SF190 since 2016),9,24,33,,2,2,9,26,35
2013,Brewing Science/Beverage Technology,664,84,748,50,43,93,714,127,841
2013,Armed Forces Administration,114,134,248,,,,114,134,248
2013,Byzantine Studies,14,17,31,14,3,17,28,20,48
2013,Caritas Science,24,60,84,13,14,27,37,74,111
2013,Chemistry,23499,14625,38124,2689,2416,5105,26188,17041,43229
2013,Chemical Engineering/Chemical Process Technology,5715,2881,8596,672,642,1314,6387,3523,9910
2013,Computer Linguistics,607,439,1046,156,272,428,763,711,1474
2013,Computer and Communication Technology,2138,1004,3142,408,162,570,2546,1166,3712
2013,Danish,21,57,78,,,,21,57,78
2013,Performing Arts/Stagecraft/Directing,341,741,1082,139,240,379,480,981,1461
2013,German as a Foreign or Second Language,200,1321,1521,255,954,1209,455,2275,2730
2013,Pastoral Care Studies,81,127,208,7,7,14,88,134,222
2013,Conducting,110,38,148,91,66,157,201,104,305
2013,Printing and Reproduction Technology,1460,942,2402,175,169,344,1635,1111,2746
2013,Gemstone and Jewellery Design,9,80,89,7,36,43,16,116,132
2013,Electrical Power Engineering,2070,262,2332,376,77,453,2446,339,2785
2013,Electrical Engineering/Electronics,49651,4278,53929,12376,2655,15031,62027,6933,68960
2013,Energy Process Engineering,7038,1395,8433,833,266,1099,7871,1661,9532
2013,Nutritional Science,297,2217,2514,35,158,193,332,2375,2707
2013,Adult Education and Extracurricular Youth Educat.,513,1632,2145,36,138,174,549,1770,2319
2013,Ed.of People w.Emot.Diff. (cl.w. SF190 since 2016),124,632,756,2,23,25,126,655,781
2013,Educational Science (Pedagogy),12797,45380,58177,670,3555,4225,13467,48935,62402
2013,Ethics,263,541,804,19,31,50,282,572,854
2013,Ethnology,1100,3190,4290,160,363,523,1260,3553,4813
2013,European Ethnology and Cultural Studies,592,2079,2671,181,399,580,773,2478,3251
2013,European Economic Studies,1999,1955,3954,113,223,336,2112,2178,4290
2013,"Protestant Religious Pedagogy, Church Educat. Work",223,519,742,10,10,20,233,529,762
2013,"Protestant Theology, Protes. Religious Education",4434,6792,11226,392,243,635,4826,7035,11861
2013,Facility Management,1606,1041,2647,76,67,143,1682,1108,2790
2013,Automotive Technology,10747,597,11344,1800,224,2024,12547,821,13368
2013,Precision Engineering,733,49,782,133,14,147,866,63,929
2013,Manufacturing Technology/Production Engineering,6186,777,6963,1232,204,1436,7418,981,8399
2013,Film and Television Studies,1193,941,2134,144,197,341,1337,1138,2475
2013,Financial Administration,716,953,1669,1,6,7,717,959,1676
2013,Finno-Ugrian Studies,28,142,170,6,27,33,34,169,203
2013,"Forest Science, Forestry",3455,1601,5056,370,290,660,3825,1891,5716
2013,French,1182,6048,7230,166,659,825,1348,6707,8055
2013,Horticulture,988,741,1729,79,86,165,1067,827,1894
2013,Ed.of Deaf a.Hearing Imp. (cl.w. SF190 since 2016),39,331,370,3,13,16,42,344,386
2013,Ed.Ment.Disabl./Pract.Work(cl.w. SF190 since 2016),290,1016,1306,3,9,12,293,1025,1318
2013,Geography,11115,9855,20970,514,571,1085,11629,10426,22055
2013,Geology/Palaeontology,494,292,786,138,100,238,632,392,1024
2013,Geoecology,407,492,899,28,23,51,435,515,950
2013,Geophysics,1612,1771,3383,103,86,189,1715,1857,3572
2013,Geosciences general,6602,4035,10637,640,464,1104,7242,4499,11741
2013,German Studies/German,16730,53833,70563,1890,7561,9451,18620,61394,80014
2013,Singing,278,552,830,232,332,564,510,884,1394
2013,History,18767,14262,33029,1138,1372,2510,19905,15634,35539
2013,Health Education,437,2470,2907,6,64,70,443,2534,2977
2013,Health Technology,4974,3756,8730,851,526,1377,5825,4282,10107
2013,Health Science/Health Management,7465,16963,24428,441,967,1408,7906,17930,25836
2013,Glass Technology/Ceramics,198,78,276,13,3,16,211,81,292
2013,Graphic Design/Communication Design,6554,8701,15255,645,1236,1881,7199,9937,17136
2013,Greek,242,240,482,35,75,110,277,315,592
2013,Primary School Education/Primary Level Education,546,3312,3858,13,84,97,559,3396,3955
2013,Domestic and Nutritional Sciences,1198,5400,6598,92,344,436,1290,5744,7034
2013,Domestic Science,46,205,251,,8,8,46,213,259
2013,Wood and Fibre Technology,948,141,1089,41,15,56,989,156,1145
2013,Timber Construction,626,109,735,12,3,15,638,112,750
2013,Wood Science,272,102,374,23,15,38,295,117,412
2013,Metallurgy and Foundry,577,113,690,230,112,342,807,225,1032
2013,Indology,71,115,186,18,26,44,89,141,230
2013,Industrial Design/Product Design,1700,1458,3158,227,289,516,1927,1747,3674
2013,Computer Science,64710,10219,74929,10030,3306,13336,74740,13525,88265
2013,Inf./Library Scien. (not at univ. of app.adm.sci.),706,2234,2940,45,141,186,751,2375,3126
2013,Computational Engineer./Technical Computer Science,7216,864,8080,1138,311,1449,8354,1175,9529
2013,Interior Architecture,405,2593,2998,71,329,400,476,2922,3398
2013,Internal Administration,1661,2906,4567,9,55,64,1670,2961,4631
2013,Instrumental Music,1462,1357,2819,1720,2525,4245,3182,3882,7064
2013,Interdisc. Studies (specialising in Engineering),10620,3176,13796,1503,705,2208,12123,3881,16004
2013,Interdisc. Studies (special. in Natural Sciences),1907,2014,3921,441,375,816,2348,2389,4737
2013,"Interdisc. St. (spec. in Law, Econ. and Soc. Sci.)",4976,6122,11098,529,1008,1537,5505,7130,12635
2013,Interdisc. Studies (spec. in Humanities),5297,14185,19482,851,2301,3152,6148,16486,22634
2013,"Interdisc. Studies (special. in Art, Art Theory)",220,566,786,44,102,146,264,668,932
2013,International Business Studies/Management,14704,18670,33374,4035,4894,8929,18739,23564,42303
2013,Iranian Studies,59,82,141,23,46,69,82,128,210
2013,Islamic Studies,601,1209,1810,238,305,543,839,1514,2353
2013,Italian,233,995,1228,88,367,455,321,1362,1683
2013,Japanese Studies,1328,1842,3170,111,269,380,1439,2111,3550
2013,Jazz and Popular Music,853,245,1098,110,47,157,963,292,1255
2013,Judaic Studies/Hebrew,210,401,611,32,71,103,242,472,714
2013,Law Enforcement,66,54,120,,,,66,54,120
2013,Cartography,372,218,590,77,69,146,449,287,736
2013,"Catholic Religious Pedagogy, Church Educat. Work",137,240,377,1,11,12,138,251,389
2013,"Catholic Theology, Catholic Religious Education",3361,4373,7734,474,188,662,3835,4561,8396
2013,Caucasian Studies,,1,1,1,2,3,1,3,4
2013,Nucl.Techn./Nucl.Process Techn.(cl.w.SF211 s.2020),25,6,31,6,2,8,31,8,39
2013,Church Music,255,141,396,47,61,108,302,202,504
2013,Classical Philology,212,290,502,36,53,89,248,343,591
2013,"Communication Technology, Information Engineering",5880,699,6579,1901,437,2338,7781,1136,8917
2013,Communication Science/Journalism,5017,9888,14905,307,1108,1415,5324,10996,16320
2013,Composition,134,33,167,125,75,200,259,108,367
2013,Ed.of Physically Disabled (cl.w. SF190 since 2016),108,301,409,1,3,4,109,304,413
2013,Arts Education,974,4379,5353,112,303,415,1086,4682,5768
2013,"Art History, Art Theory",1983,8809,10792,243,1125,1368,2226,9934,12160
2013,Plastics Technology,1224,219,1443,131,29,160,1355,248,1603
2013,Land Management Engineering/Landscape Design,2075,2470,4545,102,188,290,2177,2658,4835
2013,Landscape Ecology/Biogeography (ex. SF385 s. 2012),572,800,1372,23,34,57,595,834,1429
2013,Latin,1650,2493,4143,43,82,125,1693,2575,4268
2013,Latin America Studies,162,458,620,35,82,117,197,540,737
2013,Food Chemistry,677,1729,2406,36,108,144,713,1837,2550
2013,Food Technology,1805,2427,4232,98,184,282,1903,2611,4514
2013,Ed. of P.w.Learning Diff. (cl.w. SF190 since 2016),900,3271,4171,5,67,72,905,3338,4243
2013,Area of study: Humanities,375,2267,2642,3,62,65,378,2329,2707
2013,Area of study: Social Studies,181,284,465,4,22,26,185,306,491
2013,Area of study: Natural Sciences/General Studies,206,696,902,5,23,28,211,719,930
2013,Area of study: Technology,566,283,849,13,6,19,579,289,868
2013,Aeronautical and Aerospace Engineering,5220,643,5863,695,118,813,5915,761,6676
2013,Painting,187,227,414,75,95,170,262,322,584
2013,Mine Surveying,15,9,24,1,2,3,16,11,27
2013,Mechanical Engineering,91518,9465,100983,13391,2399,15790,104909,11864,116773
2013,Math.Statistics/Prob.Calc. (class.w. SF312 s.2020),938,758,1696,154,171,325,1092,929,2021
2013,Mathematics,28814,26705,55519,2621,2278,4899,31435,28983,60418
2013,Mechatronics,13000,958,13958,2193,252,2445,15193,1210,16403
2013,Media Informatics,10201,3993,14194,819,482,1301,11020,4475,15495
2013,Media Technology,3396,2003,5399,178,122,300,3574,2125,5699
2013,Media Economics/Media Management,2736,4563,7299,167,331,498,2903,4894,7797
2013,Media Science,3467,6598,10065,294,861,1155,3761,7459,11220
2013,Medicine (General Medicine),29132,47002,76134,4878,5364,10242,34010,52366,86376
2013,Medical Informatics,1227,784,2011,221,268,489,1448,1052,2500
2013,Metals Technology,631,113,744,5,4,9,636,117,753
2013,Meteorology,865,569,1434,61,66,127,926,635,1561
2013,Microelectronics,79,4,83,76,26,102,155,30,185
2013,Microsystems Technology,1515,240,1755,624,157,781,2139,397,2536
2013,Dairy Farming,37,61,98,3,10,13,40,71,111
2013,Mineralogy,60,45,105,20,17,37,80,62,142
2013,Medieval and Modern History,998,647,1645,73,69,142,1071,716,1787
2013,Music Education,3224,4193,7417,206,449,655,3430,4642,8072
2013,Musicology/History of Music,2398,2554,4952,274,495,769,2672,3049,5721
2013,Nature Conservation,325,483,808,104,148,252,429,631,1060
2013,Nautical Science/Maritime Studies,1234,245,1479,34,11,45,1268,256,1524
2013,New Media,812,600,1412,143,148,291,955,748,1703
2013,Modern Greek,9,24,33,17,36,53,26,60,86
2013,Non-medical Healthcare Professions/Therapies,1518,5871,7389,136,307,443,1654,6178,7832
2013,Low German,3,5,8,1,,1,4,5,9
2013,Dutch,156,291,447,18,35,53,174,326,500
2013,"Nordic/Scand. St. (Nord. Phil., ind. lang. n.e.c.)",430,1204,1634,28,113,141,458,1317,1775
2013,Optoelectronics,592,152,744,120,26,146,712,178,890
2013,Orchestral Music,393,387,780,358,474,832,751,861,1612
2013,"Oriental Studies, Ancient Oriental Studies",535,837,1372,116,203,319,651,1040,1691
2013,Eastern and South Eastern Europe Studies,228,411,639,46,141,187,274,552,826
2013,Oceanography,12,8,20,10,9,19,22,17,39
2013,Early Childhood Education,148,1097,1245,5,57,62,153,1154,1307
2013,Plant Production,320,260,580,13,11,24,333,271,604
2013,Nursing Science/Nursing Management,2418,7157,9575,65,283,348,2483,7440,9923
2013,Pharmacy,3754,9054,12808,662,1162,1824,4416,10216,14632
2013,Philosophy,8892,6127,15019,1200,896,2096,10092,7023,17115
2013,Physics,31204,10036,41240,3232,1430,4662,34436,11466,45902
2013,Engineering Physics/Mechanical Process Engineering,3148,622,3770,499,124,623,3647,746,4393
2013,Political Science,15568,10338,25906,1993,2391,4384,17561,12729,30290
2013,Police/Protection of the Constitution,9103,4670,13773,70,32,102,9173,4702,13875
2013,Polish,40,105,145,9,43,52,49,148,197
2013,Portuguese,19,86,105,14,48,62,33,134,167
2013,Psychology,13998,42025,56023,911,3373,4284,14909,45398,60307
2013,Spatial Planning,2363,2359,4722,322,476,798,2685,2835,5520
2013,Administration of Justice,800,1193,1993,,,,800,1193,1993
2013,Law,45170,51952,97122,3631,6446,10077,48801,58398,107199
2013,Renewable Energy,538,114,652,134,45,179,672,159,831
2013,Religious Studies,599,1050,1649,105,150,255,704,1200,1904
2013,Restoration Studies,204,821,1025,11,56,67,215,877,1092
2013,Rhythmics,5,20,25,2,12,14,7,32,39
2013,"Romance Studies (Rom. Phil., indiv. lang. n.e.c.)",752,3203,3955,285,1063,1348,1037,4266,5303
2013,Russian,257,746,1003,64,315,379,321,1061,1382
2013,General Studies (including School Garden),28,163,191,1,2,3,29,165,194
2013,Drama Studies,266,235,501,24,29,53,290,264,554
2013,Naval Architecture/Ship Technology,816,146,962,114,14,128,930,160,1090
2013,School Pedagogy,291,500,791,26,27,53,317,527,844
2013,Sinology/Korean Studies,1136,1696,2832,138,444,582,1274,2140,3414
2013,Slavic Studies (Slavic Philology),476,1144,1620,135,746,881,611,1890,2501
2013,Special Needs Education,1081,5476,6557,19,185,204,1100,5661,6761
2013,Other subjects,633,1017,1650,508,620,1128,1141,1637,2778
2013,Other regional studies,153,262,415,34,80,114,187,342,529
2013,Sorabistics,10,21,31,1,4,5,11,25,36
2013,Social Work,8435,26454,34889,438,1565,2003,8873,28019,36892
2013,Social Studies,1658,1566,3224,55,99,154,1713,1665,3378
2013,Social Pedagogy,1229,5191,6420,30,145,175,1259,5336,6595
2013,Social Security Administration,536,1167,1703,4,1,5,540,1168,1708
2013,Applied Social Science,5303,17653,22956,210,854,1064,5513,18507,24020
2013,Social Sciences,7667,9815,17482,649,1250,1899,8316,11065,19381
2013,Sociology,6788,10506,17294,529,1327,1856,7317,11833,19150
2013,Spanish,1254,4651,5905,255,713,968,1509,5364,6873
2013,Sports Management/Sports Economics,2253,942,3195,117,51,168,2370,993,3363
2013,Sports Education/Sports Psychology,6258,4520,10778,240,142,382,6498,4662,11160
2013,Sports Science,10225,5942,16167,503,233,736,10728,6175,16903
2013,Speech Therapy/Logopedics (cl.w. SF190 since 2016),58,917,975,1,21,22,59,938,997
2013,Steel Construction,36,1,37,,,,36,1,37
2013,"South Slavic (Bulgar., Serbo-Croat., Slovene etc.)",9,26,35,7,13,20,16,39,55
2013,Dance Education,39,143,182,53,128,181,92,271,363
2013,Technical Cybernetics,444,86,530,29,10,39,473,96,569
2013,Technomathematics,1207,334,1541,68,39,107,1275,373,1648
2013,Textile Design,285,2844,3129,61,406,467,346,3250,3596
2013,Textile and Clothing Technology/Industry,282,2376,2658,196,308,504,478,2684,3162
2013,Theatre Studies,743,2172,2915,68,287,355,811,2459,3270
2013,Veterinary Medicine,1098,6475,7573,200,388,588,1298,6863,8161
2013,Animal Production,58,161,219,16,17,33,74,178,252
2013,Sound Engineering,285,33,318,29,13,42,314,46,360
2013,Tourism Management,1325,6288,7613,236,716,952,1561,7004,8565
2013,Transport and Conveying Technology,390,26,416,69,17,86,459,43,502
2013,Czech,8,16,24,,7,7,8,23,31
2013,Turkish Studies,67,200,267,56,103,159,123,303,426
2013,Environmental Protection,1366,1193,2559,288,245,533,1654,1438,3092
2013,Environmental Technology (including Recycling),6355,2847,9202,584,499,1083,6939,3346,10285
2013,Prehistory and Early History,465,567,1032,34,43,77,499,610,1109
2013,Process Engineering,6915,3499,10414,853,686,1539,7768,4185,11953
2013,Ed.of P.w.Behav.Disorders (cl.w. SF190 since 2016),134,556,690,,14,14,134,570,704
2013,Transport Engineering,3685,1022,4707,431,171,602,4116,1193,5309
2013,Transport Economics,1228,667,1895,111,103,214,1339,770,2109
2013,Surveying (Geodesy),3300,1332,4632,495,285,780,3795,1617,5412
2013,Supply Technology,3377,410,3787,196,74,270,3573,484,4057
2013,Administrative Science/Public Administration,4912,6420,11332,219,309,528,5131,6729,11860
2013,Folklore,476,1415,1891,36,146,182,512,1561,2073
2013,Economics,13011,5844,18855,1734,1983,3717,14745,7827,22572
2013,Hydraulic Engineering,733,417,1150,63,71,134,796,488,1284
2013,Water Management,838,475,1313,218,185,403,1056,660,1716
2013,Viticulture and Oenology,605,288,893,73,36,109,678,324,1002
2013,Handicrafts (technical)/Technology,180,242,422,9,14,23,189,256,445
2013,Handicrafts Education,26,52,78,,,,26,52,78
2013,Materials Technology,4883,1398,6281,894,433,1327,5777,1831,7608
2013,Western Slavic (general and n.e.c.),32,43,75,9,47,56,41,90,131
2013,Economic/Social Geography,224,212,436,8,20,28,232,232,464
2013,Economic/Social History,99,90,189,7,16,23,106,106,212
2013,Business Informatics,36037,7832,43869,3663,2120,5783,39700,9952,49652
2013,Business Engineering spec. in Engineering Sciences,40513,9488,50001,3862,2003,5865,44375,11491,55866
2013,Business Engineering specialising in Economics,28285,8868,37153,2914,1501,4415,31199,10369,41568
2013,Business Mathematics,4363,2793,7156,498,650,1148,4861,3443,8304
2013,Business and Economics Education,2607,4444,7051,91,232,323,2698,4676,7374
2013,Business Law,8524,9313,17837,555,932,1487,9079,10245,19324
2013,Business and Economics,45379,34523,79902,4289,5677,9966,49668,40200,89868
2013,History of Science/History of Technology,37,19,56,5,18,23,42,37,79
2013,Dentistry,4579,8294,12873,877,1070,1947,5456,9364,14820
2013,Customs and Tax Administration,1867,2290,4157,1,1,2,1868,2291,4159
2014,Waste Management,61,31,92,6,2,8,67,33,100
2014,African Studies,388,764,1152,202,196,398,590,960,1550
2014,Agricultural Biology,149,212,361,108,81,189,257,293,550
2014,Agricultural Economics,741,582,1323,218,189,407,959,771,1730
2014,Agricultural Science/Agriculture,7993,7427,15420,1023,894,1917,9016,8321,17337
2014,Egyptology,145,332,477,23,36,59,168,368,536
2014,General Linguistics/Indo-European Studies,1332,4169,5501,276,939,1215,1608,5108,6716
2014,General Literary Studies,836,2907,3743,157,528,685,993,3435,4428
2014,Ancient History,157,119,276,27,21,48,184,140,324
2014,American Studies,936,2095,3031,185,487,672,1121,2582,3703
2014,Applied Art,1432,2319,3751,216,288,504,1648,2607,4255
2014,Applied Linguistics,896,3895,4791,218,787,1005,1114,4682,5796
2014,Applied Systems Science,1612,317,1929,375,131,506,1987,448,2435
2014,English Studies,12003,30226,42229,1099,3433,4532,13102,33659,46761
2014,Anthropology (Human Biology),158,336,494,59,91,150,217,427,644
2014,Arabic/Arabic Studies,209,353,562,72,48,120,281,401,682
2014,Work Studies/Business Studies,846,1326,2172,21,55,76,867,1381,2248
2014,Occupational Guidance and Career Counselling,39,161,200,,2,2,39,163,202
2014,Labour Administration,220,578,798,2,6,8,222,584,806
2014,Archaeology,2329,2798,5127,189,278,467,2518,3076,5594
2014,Archaeometry (Archaeological Engineering),25,17,42,,,,25,17,42
2014,Architecture,13529,16119,29648,2915,4103,7018,16444,20222,36666
2014,Archive and Documentation Science,116,197,313,13,25,38,129,222,351
2014,Archive Studies,92,125,217,4,8,12,96,133,229
2014,Asian Languages and Cultures/Asian Studies,639,1154,1793,153,350,503,792,1504,2296
2014,Astrophysics and Astronomy,208,67,275,112,70,182,320,137,457
2014,Ophthalmic Optics,217,557,774,31,29,60,248,586,834
2014,Immigrant Education,20,145,165,22,47,69,42,192,234
2014,Non-Europ. Lang. and Cult. in Oceania and America,82,156,238,36,69,105,118,225,343
2014,Foreign Affairs Administration,46,110,156,,,,46,110,156
2014,Baltic Studies,5,4,9,,2,2,5,6,11
2014,Banking,368,255,623,2,4,6,370,259,629
2014,Civil Engineering/Structural Engineering,32597,12492,45089,5994,2494,8488,38591,14986,53577
2014,Mining/Mine Engineering,1279,197,1476,342,78,420,1621,275,1896
2014,Occupation-specific Foreign Language Training,454,1238,1692,80,270,350,534,1508,2042
2014,"Vocational, Business and Economics Education",712,802,1514,60,97,157,772,899,1671
2014,Business Administration,109394,98351,207745,10409,13633,24042,119803,111984,231787
2014,Librarianship,10,29,39,,,,10,29,39
2014,Fine Arts/Graphics,1235,1573,2808,344,584,928,1579,2157,3736
2014,Sculpting/Statuary Art,161,200,361,52,130,182,213,330,543
2014,Biochemistry,3191,3883,7074,389,493,882,3580,4376,7956
2014,Bioinformatics,1133,586,1719,208,161,369,1341,747,2088
2014,Biology,16941,29618,46559,2344,3402,5746,19285,33020,52305
2014,Biomedicine,493,948,1441,183,250,433,676,1198,1874
2014,Biotechnology,4922,5763,10685,553,634,1187,5475,6397,11872
2014,Ed.of Blind a.Visually Imp.(cl.w.SF190 since 2016),11,29,40,,,,11,29,40
2014,Brewing Science/Beverage Technology,652,109,761,42,36,78,694,145,839
2014,Armed Forces Administration,136,154,290,,,,136,154,290
2014,Byzantine Studies,12,19,31,18,8,26,30,27,57
2014,Caritas Science,40,70,110,15,16,31,55,86,141
2014,Chemistry,24163,14740,38903,2829,2630,5459,26992,17370,44362
2014,Chemical Engineering/Chemical Process Technology,5821,2902,8723,777,723,1500,6598,3625,10223
2014,Computer Linguistics,628,446,1074,165,279,444,793,725,1518
2014,Computer and Communication Technology,2448,1240,3688,579,201,780,3027,1441,4468
2014,Danish,17,53,70,,,,17,53,70
2014,Performing Arts/Stagecraft/Directing,329,763,1092,140,274,414,469,1037,1506
2014,German as a Foreign or Second Language,230,1521,1751,230,935,1165,460,2456,2916
2014,Pastoral Care Studies,79,150,229,8,10,18,87,160,247
2014,Conducting,99,53,152,86,76,162,185,129,314
2014,Printing and Reproduction Technology,1100,876,1976,187,180,367,1287,1056,2343
2014,Gemstone and Jewellery Design,11,79,90,8,30,38,19,109,128
2014,Electrical Power Engineering,2248,327,2575,389,101,490,2637,428,3065
2014,Electrical Engineering/Electronics,49117,4585,53702,13075,2955,16030,62192,7540,69732
2014,Energy Process Engineering,6775,1379,8154,846,286,1132,7621,1665,9286
2014,Nutritional Science,341,2211,2552,45,193,238,386,2404,2790
2014,Adult Education and Extracurricular Youth Educat.,524,1735,2259,33,123,156,557,1858,2415
2014,Ed.of People w.Emot.Diff. (cl.w. SF190 since 2016),195,1001,1196,2,26,28,197,1027,1224
2014,Educational Science (Pedagogy),12862,46476,59338,691,3621,4312,13553,50097,63650
2014,Ethics,328,664,992,20,46,66,348,710,1058
2014,Ethnology,1102,3112,4214,160,399,559,1262,3511,4773
2014,European Ethnology and Cultural Studies,599,2111,2710,190,406,596,789,2517,3306
2014,European Economic Studies,2077,2080,4157,120,229,349,2197,2309,4506
2014,"Protestant Religious Pedagogy, Church Educat. Work",240,529,769,9,12,21,249,541,790
2014,"Protestant Theology, Protes. Religious Education",4782,7033,11815,404,261,665,5186,7294,12480
2014,Facility Management,1762,1188,2950,84,59,143,1846,1247,3093
2014,Automotive Technology,11154,669,11823,1986,267,2253,13140,936,14076
2014,Precision Engineering,578,30,608,94,9,103,672,39,711
2014,Manufacturing Technology/Production Engineering,6126,835,6961,1356,229,1585,7482,1064,8546
2014,Film and Television Studies,1223,1005,2228,138,202,340,1361,1207,2568
2014,Financial Administration,744,945,1689,,4,4,744,949,1693
2014,Finno-Ugrian Studies,38,119,157,8,15,23,46,134,180
2014,"Forest Science, Forestry",3597,1741,5338,410,321,731,4007,2062,6069
2014,French,1175,5835,7010,181,648,829,1356,6483,7839
2014,Horticulture,995,746,1741,97,90,187,1092,836,1928
2014,Ed.of Deaf a.Hearing Imp. (cl.w. SF190 since 2016),40,353,393,1,14,15,41,367,408
2014,Ed.Ment.Disabl./Pract.Work(cl.w. SF190 since 2016),279,1074,1353,2,8,10,281,1082,1363
2014,Geography,11119,9985,21104,538,576,1114,11657,10561,22218
2014,Geology/Palaeontology,437,258,695,141,91,232,578,349,927
2014,Geoecology,493,548,1041,25,26,51,518,574,1092
2014,Geophysics,1441,1507,2948,134,84,218,1575,1591,3166
2014,Geosciences general,6610,4035,10645,699,510,1209,7309,4545,11854
2014,German Studies/German,16105,52716,68821,1912,7359,9271,18017,60075,78092
2014,Singing,266,562,828,244,348,592,510,910,1420
2014,History,19024,14068,33092,1176,1419,2595,20200,15487,35687
2014,Health Education,445,2356,2801,6,52,58,451,2408,2859
2014,Health Technology,5151,4119,9270,901,626,1527,6052,4745,10797
2014,Health Science/Health Management,8714,20222,28936,570,1201,1771,9284,21423,30707
2014,Glass Technology/Ceramics,190,75,265,14,12,26,204,87,291
2014,Graphic Design/Communication Design,6563,9198,15761,726,1394,2120,7289,10592,17881
2014,Greek,254,227,481,39,79,118,293,306,599
2014,Primary School Education/Primary Level Education,601,3595,4196,13,94,107,614,3689,4303
2014,Domestic and Nutritional Sciences,1351,6101,7452,118,380,498,1469,6481,7950
2014,Domestic Science,50,170,220,,6,6,50,176,226
2014,Wood and Fibre Technology,920,152,1072,41,19,60,961,171,1132
2014,Timber Construction,644,109,753,14,2,16,658,111,769
2014,Wood Science,326,92,418,20,7,27,346,99,445
2014,Metallurgy and Foundry,690,205,895,233,124,357,923,329,1252
2014,Indology,72,110,182,21,26,47,93,136,229
2014,Industrial Design/Product Design,1722,1523,3245,236,309,545,1958,1832,3790
2014,Computer Science,68429,11970,80399,10862,3655,14517,79291,15625,94916
2014,Inf./Library Scien. (not at univ. of app.adm.sci.),681,2233,2914,39,147,186,720,2380,3100
2014,Computational Engineer./Technical Computer Science,7600,961,8561,1340,338,1678,8940,1299,10239
2014,Interior Architecture,401,2614,3015,66,327,393,467,2941,3408
2014,Internal Administration,1662,3126,4788,17,49,66,1679,3175,4854
2014,Instrumental Music,1354,1225,2579,1790,2443,4233,3144,3668,6812
2014,Interdisc. Studies (specialising in Engineering),10726,3356,14082,1601,767,2368,12327,4123,16450
2014,Interdisc. Studies (special. in Natural Sciences),2090,2204,4294,520,425,945,2610,2629,5239
2014,"Interdisc. St. (spec. in Law, Econ. and Soc. Sci.)",5247,6208,11455,621,1086,1707,5868,7294,13162
2014,Interdisc. Studies (spec. in Humanities),5216,14376,19592,898,2456,3354,6114,16832,22946
2014,"Interdisc. Studies (special. in Art, Art Theory)",243,663,906,42,108,150,285,771,1056
2014,International Business Studies/Management,15689,19681,35370,4544,5303,9847,20233,24984,45217
2014,Iranian Studies,52,92,144,34,48,82,86,140,226
2014,Islamic Studies,647,1240,1887,254,354,608,901,1594,2495
2014,Italian,238,1014,1252,93,378,471,331,1392,1723
2014,Japanese Studies,1350,1760,3110,120,282,402,1470,2042,3512
2014,Jazz and Popular Music,889,263,1152,119,52,171,1008,315,1323
2014,Judaic Studies/Hebrew,231,422,653,33,74,107,264,496,760
2014,Law Enforcement,60,58,118,,,,60,58,118
2014,Cartography,313,167,480,72,68,140,385,235,620
2014,"Catholic Religious Pedagogy, Church Educat. Work",137,239,376,2,11,13,139,250,389
2014,"Catholic Theology, Catholic Religious Education",3343,4348,7691,478,187,665,3821,4535,8356
2014,Caucasian Studies,3,2,5,,1,1,3,3,6
2014,Nucl.Techn./Nucl.Process Techn.(cl.w.SF211 s.2020),15,5,20,6,,6,21,5,26
2014,Church Music,260,124,384,38,71,109,298,195,493
2014,Classical Philology,206,250,456,39,51,90,245,301,546
2014,"Communication Technology, Information Engineering",5479,736,6215,1994,473,2467,7473,1209,8682
2014,Communication Science/Journalism,5225,10713,15938,321,1273,1594,5546,11986,17532
2014,Composition,148,32,180,109,89,198,257,121,378
2014,Ed.of Physically Disabled (cl.w. SF190 since 2016),103,310,413,1,1,2,104,311,415
2014,Arts Education,940,4313,5253,101,343,444,1041,4656,5697
2014,"Art History, Art Theory",2039,8659,10698,253,1150,1403,2292,9809,12101
2014,Plastics Technology,1216,214,1430,146,32,178,1362,246,1608
2014,Land Management Engineering/Landscape Design,2127,2564,4691,117,236,353,2244,2800,5044
2014,Landscape Ecology/Biogeography (ex. SF385 s. 2012),612,855,1467,17,35,52,629,890,1519
2014,Latin,1618,2306,3924,33,86,119,1651,2392,4043
2014,Latin America Studies,177,440,617,33,79,112,210,519,729
2014,Food Chemistry,696,1683,2379,29,112,141,725,1795,2520
2014,Food Technology,1872,2461,4333,108,203,311,1980,2664,4644
2014,Ed. of P.w.Learning Diff. (cl.w. SF190 since 2016),854,3230,4084,5,68,73,859,3298,4157
2014,Area of study: Humanities,456,2779,3235,2,67,69,458,2846,3304
2014,Area of study: Social Studies,188,253,441,5,20,25,193,273,466
2014,Area of study: Natural Sciences/General Studies,239,866,1105,6,34,40,245,900,1145
2014,Area of study: Technology,632,296,928,14,6,20,646,302,948
2014,Aeronautical and Aerospace Engineering,5327,660,5987,762,134,896,6089,794,6883
2014,Painting,189,219,408,80,117,197,269,336,605
2014,Mine Surveying,13,8,21,2,2,4,15,10,25
2014,Mechanical Engineering,91651,9997,101648,14772,2682,17454,106423,12679,119102
2014,Math.Statistics/Prob.Calc. (class.w. SF312 s.2020),1040,900,1940,161,188,349,1201,1088,2289
2014,Mathematics,28809,26568,55377,2595,2295,4890,31404,28863,60267
2014,Mechatronics,13307,997,14304,2471,308,2779,15778,1305,17083
2014,Media Informatics,10644,4357,15001,892,583,1475,11536,4940,16476
2014,Media Technology,3909,2375,6284,214,174,388,4123,2549,6672
2014,Media Economics/Media Management,3144,5293,8437,189,389,578,3333,5682,9015
2014,Media Science,3657,7061,10718,320,920,1240,3977,7981,11958
2014,Medicine (General Medicine),29661,47770,77431,4850,5582,10432,34511,53352,87863
2014,Medical Informatics,1249,813,2062,221,305,526,1470,1118,2588
2014,Metals Technology,603,120,723,9,6,15,612,126,738
2014,Meteorology,898,647,1545,62,83,145,960,730,1690
2014,Microelectronics,153,4,157,130,34,164,283,38,321
2014,Microsystems Technology,1525,266,1791,794,180,974,2319,446,2765
2014,Dairy Farming,48,55,103,7,10,17,55,65,120
2014,Mineralogy,53,40,93,31,19,50,84,59,143
2014,Medieval and Modern History,658,512,1170,58,60,118,716,572,1288
2014,Music Education,3303,4227,7530,213,467,680,3516,4694,8210
2014,Musicology/History of Music,2447,2520,4967,276,534,810,2723,3054,5777
2014,Nature Conservation,350,507,857,119,150,269,469,657,1126
2014,Nautical Science/Maritime Studies,1075,226,1301,36,10,46,1111,236,1347
2014,New Media,775,632,1407,136,162,298,911,794,1705
2014,Modern Greek,8,24,32,16,45,61,24,69,93
2014,Non-medical Healthcare Professions/Therapies,1742,6668,8410,402,780,1182,2144,7448,9592
2014,Low German,5,24,29,,1,1,5,25,30
2014,Dutch,174,335,509,14,34,48,188,369,557
2014,"Nordic/Scand. St. (Nord. Phil., ind. lang. n.e.c.)",395,1194,1589,34,95,129,429,1289,1718
2014,Optoelectronics,587,152,739,122,36,158,709,188,897
2014,Orchestral Music,433,441,874,405,557,962,838,998,1836
2014,"Oriental Studies, Ancient Oriental Studies",634,893,1527,137,211,348,771,1104,1875
2014,Eastern and South Eastern Europe Studies,227,402,629,48,137,185,275,539,814
2014,Oceanography,13,7,20,8,7,15,21,14,35
2014,Early Childhood Education,197,1419,1616,6,69,75,203,1488,1691
2014,Plant Production,376,309,685,19,10,29,395,319,714
2014,Nursing Science/Nursing Management,2654,8078,10732,69,324,393,2723,8402,11125
2014,Pharmacy,3973,9318,13291,698,1279,1977,4671,10597,15268
2014,Philosophy,8940,6359,15299,1214,923,2137,10154,7282,17436
2014,Physics,31519,10860,42379,3592,1601,5193,35111,12461,47572
2014,Engineering Physics/Mechanical Process Engineering,3162,695,3857,618,171,789,3780,866,4646
2014,Political Science,15361,10443,25804,1960,2481,4441,17321,12924,30245
2014,Police/Protection of the Constitution,9526,4526,14052,64,18,82,9590,4544,14134
2014,Polish,37,99,136,8,42,50,45,141,186
2014,Portuguese,20,83,103,14,41,55,34,124,158
2014,Psychology,15254,44900,60154,1003,3517,4520,16257,48417,64674
2014,Spatial Planning,2328,2350,4678,347,547,894,2675,2897,5572
2014,Administration of Justice,468,1489,1957,,,,468,1489,1957
2014,Law,45762,53463,99225,3648,6732,10380,49410,60195,109605
2014,Renewable Energy,571,132,703,132,49,181,703,181,884
2014,Religious Studies,677,1159,1836,97,142,239,774,1301,2075
2014,Restoration Studies,193,817,1010,15,56,71,208,873,1081
2014,Rhythmics,7,33,40,2,10,12,9,43,52
2014,"Romance Studies (Rom. Phil., indiv. lang. n.e.c.)",731,3102,3833,272,1075,1347,1003,4177,5180
2014,Russian,289,730,1019,61,288,349,350,1018,1368
2014,General Studies (including School Garden),33,182,215,1,,1,34,182,216
2014,Drama Studies,263,241,504,29,25,54,292,266,558
2014,Naval Architecture/Ship Technology,823,146,969,163,27,190,986,173,1159
2014,School Pedagogy,321,593,914,30,35,65,351,628,979
2014,Sinology/Korean Studies,1099,1628,2727,171,481,652,1270,2109,3379
2014,Slavic Studies (Slavic Philology),487,1158,1645,145,693,838,632,1851,2483
2014,Special Needs Education,1040,5600,6640,21,176,197,1061,5776,6837
2014,Other subjects,660,1129,1789,569,699,1268,1229,1828,3057
2014,Other regional studies,173,276,449,45,95,140,218,371,589
2014,Sorabistics,5,22,27,,2,2,5,24,29
2014,Social Work,8974,27826,36800,457,1697,2154,9431,29523,38954
2014,Social Studies,1629,1529,3158,53,96,149,1682,1625,3307
2014,Social Pedagogy,1263,5713,6976,36,174,210,1299,5887,7186
2014,Social Security Administration,502,1126,1628,3,2,5,505,1128,1633
2014,Applied Social Science,5352,18417,23769,198,922,1120,5550,19339,24889
2014,Social Sciences,7846,10321,18167,697,1381,2078,8543,11702,20245
2014,Sociology,6724,10574,17298,552,1344,1896,7276,11918,19194
2014,Spanish,1294,4677,5971,264,745,1009,1558,5422,6980
2014,Sports Management/Sports Economics,2512,1154,3666,137,75,212,2649,1229,3878
2014,Sports Education/Sports Psychology,6008,4244,10252,229,148,377,6237,4392,10629
2014,Sports Science,10551,6122,16673,556,240,796,11107,6362,17469
2014,Speech Therapy/Logopedics (cl.w. SF190 since 2016),80,1029,1109,1,25,26,81,1054,1135
2014,Steel Construction,36,1,37,,1,1,36,2,38
2014,"South Slavic (Bulgar., Serbo-Croat., Slovene etc.)",11,22,33,5,11,16,16,33,49
2014,Dance Education,33,127,160,51,128,179,84,255,339
2014,Technical Cybernetics,472,104,576,32,12,44,504,116,620
2014,Technomathematics,1257,384,1641,83,51,134,1340,435,1775
2014,Textile Design,265,2619,2884,58,423,481,323,3042,3365
2014,Textile and Clothing Technology/Industry,352,2610,2962,210,309,519,562,2919,3481
2014,Theatre Studies,735,2221,2956,57,276,333,792,2497,3289
2014,Veterinary Medicine,1099,6457,7556,194,404,598,1293,6861,8154
2014,Animal Production,68,211,279,25,16,41,93,227,320
2014,Sound Engineering,387,43,430,35,14,49,422,57,479
2014,Tourism Management,1406,6409,7815,252,727,979,1658,7136,8794
2014,Transport and Conveying Technology,389,23,412,43,1,44,432,24,456
2014,Czech,10,12,22,,7,7,10,19,29
2014,Turkish Studies,91,272,363,76,135,211,167,407,574
2014,Environmental Protection,1269,1203,2472,323,243,566,1592,1446,3038
2014,Environmental Technology (including Recycling),5965,2840,8805,583,500,1083,6548,3340,9888
2014,Prehistory and Early History,430,503,933,31,46,77,461,549,1010
2014,Process Engineering,6769,3445,10214,905,700,1605,7674,4145,11819
2014,Ed.of P.w.Behav.Disorders (cl.w. SF190 since 2016),149,606,755,1,17,18,150,623,773
2014,Transport Engineering,3728,1092,4820,517,187,704,4245,1279,5524
2014,Transport Economics,1282,660,1942,146,124,270,1428,784,2212
2014,Surveying (Geodesy),3402,1408,4810,556,306,862,3958,1714,5672
2014,Supply Technology,3335,403,3738,215,79,294,3550,482,4032
2014,Administrative Science/Public Administration,5214,6804,12018,262,365,627,5476,7169,12645
2014,Folklore,472,1430,1902,29,144,173,501,1574,2075
2014,Economics,13504,6142,19646,1878,2172,4050,15382,8314,23696
2014,Hydraulic Engineering,757,438,1195,83,81,164,840,519,1359
2014,Water Management,863,451,1314,221,191,412,1084,642,1726
2014,Viticulture and Oenology,631,308,939,85,44,129,716,352,1068
2014,Handicrafts (technical)/Technology,147,243,390,4,17,21,151,260,411
2014,Handicrafts Education,23,67,90,,1,1,23,68,91
2014,Materials Technology,5051,1452,6503,1008,509,1517,6059,1961,8020
2014,Western Slavic (general and n.e.c.),29,42,71,7,29,36,36,71,107
2014,Economic/Social Geography,226,209,435,8,15,23,234,224,458
2014,Economic/Social History,100,98,198,6,14,20,106,112,218
2014,Business Informatics,37855,8125,45980,3974,2387,6361,41829,10512,52341
2014,Business Engineering spec. in Engineering Sciences,44328,10582,54910,4473,2332,6805,48801,12914,61715
2014,Business Engineering specialising in Economics,26627,8273,34900,2841,1416,4257,29468,9689,39157
2014,Business Mathematics,4526,2908,7434,508,658,1166,5034,3566,8600
2014,Business and Economics Education,2686,4540,7226,96,253,349,2782,4793,7575
2014,Business Law,8766,9963,18729,603,958,1561,9369,10921,20290
2014,Business and Economics,45597,34976,80573,4375,5800,10175,49972,40776,90748
2014,History of Science/History of Technology,37,20,57,4,9,13,41,29,70
2014,Dentistry,4505,8428,12933,969,1118,2087,5474,9546,15020
2014,Customs and Tax Administration,1836,2389,4225,1,1,2,1837,2390,4227
2015,Waste Management,64,35,99,5,,5,69,35,104
2015,African Studies,394,759,1153,211,231,442,605,990,1595
2015,Agricultural Biology,141,193,334,160,115,275,301,308,609
2015,Agricultural Economics,819,595,1414,237,198,435,1056,793,1849
2015,Agricultural Science/Agriculture,8158,7578,15736,1076,974,2050,9234,8552,17786
2015,Egyptology,200,346,546,51,53,104,251,399,650
2015,General Linguistics/Indo-European Studies,1356,4227,5583,263,981,1244,1619,5208,6827
2015,General Literary Studies,852,3009,3861,138,499,637,990,3508,4498
2015,Ancient History,129,97,226,23,20,43,152,117,269
2015,American Studies,927,2031,2958,218,517,735,1145,2548,3693
2015,Applied Art,1465,2349,3814,226,346,572,1691,2695,4386
2015,Applied Linguistics,900,4059,4959,195,832,1027,1095,4891,5986
2015,Applied Systems Science,1643,379,2022,422,139,561,2065,518,2583
2015,English Studies,11771,29327,41098,1170,3583,4753,12941,32910,45851
2015,Anthropology (Human Biology),139,338,477,68,90,158,207,428,635
2015,Arabic/Arabic Studies,235,383,618,68,57,125,303,440,743
2015,Work Studies/Business Studies,679,991,1670,20,64,84,699,1055,1754
2015,Occupational Guidance and Career Counselling,67,189,256,,3,3,67,192,259
2015,Labour Administration,278,682,960,5,10,15,283,692,975
2015,Archaeology,2280,2771,5051,168,279,447,2448,3050,5498
2015,Archaeometry (Archaeological Engineering),27,13,40,,1,1,27,14,41
2015,Architecture,13606,16044,29650,2918,4194,7112,16524,20238,36762
2015,Archive and Documentation Science,114,194,308,14,30,44,128,224,352
2015,Archive Studies,109,146,255,3,13,16,112,159,271
2015,Asian Languages and Cultures/Asian Studies,561,1083,1644,151,333,484,712,1416,2128
2015,Astrophysics and Astronomy,207,68,275,120,67,187,327,135,462
2015,Ophthalmic Optics,206,532,738,33,24,57,239,556,795
2015,Immigrant Education,13,148,161,16,44,60,29,192,221
2015,Non-Europ. Lang. and Cult. in Oceania and America,82,156,238,35,78,113,117,234,351
2015,Foreign Affairs Administration,53,135,188,,,,53,135,188
2015,Baltic Studies,5,2,7,,1,1,5,3,8
2015,Banking,345,234,579,2,5,7,347,239,586
2015,Civil Engineering/Structural Engineering,33030,13065,46095,6087,2607,8694,39117,15672,54789
2015,Mining/Mine Engineering,1247,196,1443,420,110,530,1667,306,1973
2015,Occupation-specific Foreign Language Training,471,1256,1727,81,267,348,552,1523,2075
2015,"Vocational, Business and Economics Education",687,774,1461,29,58,87,716,832,1548
2015,Business Administration,110577,99995,210572,10527,13616,24143,121104,113611,234715
2015,Librarianship,12,39,51,,,,12,39,51
2015,Fine Arts/Graphics,1299,1633,2932,384,702,1086,1683,2335,4018
2015,Sculpting/Statuary Art,125,134,259,44,100,144,169,234,403
2015,Biochemistry,3130,3962,7092,407,564,971,3537,4526,8063
2015,Bioinformatics,1214,668,1882,201,171,372,1415,839,2254
2015,Biology,16729,28909,45638,2339,3660,5999,19068,32569,51637
2015,Biomedicine,504,992,1496,214,275,489,718,1267,1985
2015,Biotechnology,5118,6065,11183,559,708,1267,5677,6773,12450
2015,Brewing Science/Beverage Technology,641,123,764,47,34,81,688,157,845
2015,Armed Forces Administration,152,175,327,,,,152,175,327
2015,Byzantine Studies,8,17,25,20,7,27,28,24,52
2015,Caritas Science,45,72,117,10,12,22,55,84,139
2015,Chemistry,24595,15102,39697,2986,2856,5842,27581,17958,45539
2015,Chemical Engineering/Chemical Process Technology,5541,2710,8251,873,754,1627,6414,3464,9878
2015,Computer Linguistics,684,505,1189,197,287,484,881,792,1673
2015,Computer and Communication Technology,2501,1382,3883,940,356,1296,3441,1738,5179
2015,Danish,19,53,72,,,,19,53,72
2015,Performing Arts/Stagecraft/Directing,321,727,1048,135,268,403,456,995,1451
2015,German as a Foreign or Second Language,414,2121,2535,364,1298,1662,778,3419,4197
2015,Pastoral Care Studies,80,175,255,12,11,23,92,186,278
2015,Conducting,102,60,162,89,68,157,191,128,319
2015,Printing and Reproduction Technology,998,846,1844,144,125,269,1142,971,2113
2015,Gemstone and Jewellery Design,9,73,82,6,35,41,15,108,123
2015,Electrical Power Engineering,2536,422,2958,499,138,637,3035,560,3595
2015,Electrical Engineering/Electronics,47865,4864,52729,13427,3102,16529,61292,7966,69258
2015,Energy Process Engineering,6183,1370,7553,940,331,1271,7123,1701,8824
2015,Nutritional Science,390,2325,2715,41,231,272,431,2556,2987
2015,Adult Education and Extracurricular Youth Educat.,539,1863,2402,29,128,157,568,1991,2559
2015,Educational Science (Pedagogy),15127,50065,65192,812,3813,4625,15939,53878,69817
2015,Ethics,375,720,1095,29,61,90,404,781,1185
2015,Ethnology,1171,3159,4330,175,367,542,1346,3526,4872
2015,European Ethnology and Cultural Studies,603,1936,2539,166,406,572,769,2342,3111
2015,European Economic Studies,1732,2045,3777,117,242,359,1849,2287,4136
2015,"Protestant Religious Pedagogy, Church Educat. Work",239,546,785,7,6,13,246,552,798
2015,"Protestant Theology, Protes. Religious Education",4769,7041,11810,382,276,658,5151,7317,12468
2015,Facility Management,1857,1219,3076,78,62,140,1935,1281,3216
2015,Automotive Technology,10975,713,11688,2066,272,2338,13041,985,14026
2015,Precision Engineering,606,41,647,93,11,104,699,52,751
2015,Manufacturing Technology/Production Engineering,5663,838,6501,1442,237,1679,7105,1075,8180
2015,Film and Television Studies,1313,996,2309,163,225,388,1476,1221,2697
2015,Financial Administration,737,921,1658,1,2,3,738,923,1661
2015,Finno-Ugrian Studies,44,126,170,7,12,19,51,138,189
2015,"Forest Science, Forestry",3620,1729,5349,433,351,784,4053,2080,6133
2015,French,1094,5225,6319,158,593,751,1252,5818,7070
2015,Horticulture,1042,755,1797,82,77,159,1124,832,1956
2015,Geography,10847,9753,20600,522,549,1071,11369,10302,21671
2015,Geology/Palaeontology,349,196,545,135,81,216,484,277,761
2015,Geoecology,596,676,1272,40,39,79,636,715,1351
2015,Geophysics,1249,1187,2436,116,64,180,1365,1251,2616
2015,Geosciences general,6627,4191,10818,773,576,1349,7400,4767,12167
2015,German Studies/German,15667,51453,67120,1725,6843,8568,17392,58296,75688
2015,Singing,271,549,820,231,348,579,502,897,1399
2015,History,18541,13879,32420,1198,1515,2713,19739,15394,35133
2015,Health Education,499,2402,2901,5,57,62,504,2459,2963
2015,Health Technology,5339,4367,9706,1004,797,1801,6343,5164,11507
2015,Health Science/Health Management,10478,23281,33759,684,1476,2160,11162,24757,35919
2015,Glass Technology/Ceramics,165,63,228,10,8,18,175,71,246
2015,Graphic Design/Communication Design,6516,9664,16180,773,1548,2321,7289,11212,18501
2015,Greek,241,206,447,39,73,112,280,279,559
2015,Primary School Education/Primary Level Education,691,3932,4623,13,96,109,704,4028,4732
2015,Domestic and Nutritional Sciences,1433,6266,7699,132,416,548,1565,6682,8247
2015,Domestic Science,67,158,225,,6,6,67,164,231
2015,Wood and Fibre Technology,958,155,1113,47,24,71,1005,179,1184
2015,Timber Construction,661,125,786,15,3,18,676,128,804
2015,Wood Science,362,91,453,16,11,27,378,102,480
2015,Metallurgy and Foundry,688,232,920,252,118,370,940,350,1290
2015,Indology,80,119,199,23,24,47,103,143,246
2015,Industrial Design/Product Design,1757,1552,3309,230,337,567,1987,1889,3876
2015,Computer Science,72664,13601,86265,12050,4231,16281,84714,17832,102546
2015,Inf./Library Scien. (not at univ. of app.adm.sci.),674,2130,2804,35,132,167,709,2262,2971
2015,Computational Engineer./Technical Computer Science,7939,1111,9050,1578,440,2018,9517,1551,11068
2015,Interior Architecture,392,2666,3058,64,343,407,456,3009,3465
2015,Internal Administration,1788,3388,5176,21,66,87,1809,3454,5263
2015,Instrumental Music,1283,1204,2487,1880,2434,4314,3163,3638,6801
2015,Interdisc. Studies (specialising in Engineering),10910,3506,14416,1678,794,2472,12588,4300,16888
2015,Interdisc. Studies (special. in Natural Sciences),2269,2293,4562,614,436,1050,2883,2729,5612
2015,"Interdisc. St. (spec. in Law, Econ. and Soc. Sci.)",5546,6591,12137,692,1162,1854,6238,7753,13991
2015,Interdisc. Studies (spec. in Humanities),5296,14104,19400,920,2568,3488,6216,16672,22888
2015,"Interdisc. Studies (special. in Art, Art Theory)",294,720,1014,56,116,172,350,836,1186
2015,International Business Studies/Management,15707,19724,35431,4768,5713,10481,20475,25437,45912
2015,Iranian Studies,57,98,155,32,44,76,89,142,231
2015,Islamic Studies/Islamic theology,93,156,249,35,51,86,128,207,335
2015,Islamic Studies,615,1277,1892,227,345,572,842,1622,2464
2015,Italian,233,878,1111,88,358,446,321,1236,1557
2015,Japanese Studies,1380,1748,3128,128,283,411,1508,2031,3539
2015,Jazz and Popular Music,868,261,1129,129,65,194,997,326,1323
2015,Judaic Studies/Hebrew,232,407,639,32,68,100,264,475,739
2015,Law Enforcement,66,63,129,,,,66,63,129
2015,Cartography,236,116,352,84,77,161,320,193,513
2015,"Catholic Religious Pedagogy, Church Educat. Work",139,270,409,3,9,12,142,279,421
2015,"Catholic Theology, Catholic Religious Education",3325,4143,7468,490,190,680,3815,4333,8148
2015,Caucasian Studies,1,1,2,,2,2,1,3,4
2015,Nucl.Techn./Nucl.Process Techn.(cl.w.SF211 s.2020),11,2,13,2,,2,13,2,15
2015,Church Music,243,118,361,29,78,107,272,196,468
2015,Classical Philology,179,183,362,40,48,88,219,231,450
2015,"Communication Technology, Information Engineering",5330,800,6130,2066,524,2590,7396,1324,8720
2015,Communication Science/Journalism,5220,11506,16726,347,1310,1657,5567,12816,18383
2015,Composition,142,30,172,106,103,209,248,133,381
2015,Arts Education,944,4157,5101,122,320,442,1066,4477,5543
2015,"Art History, Art Theory",2051,8514,10565,221,1136,1357,2272,9650,11922
2015,Plastics Technology,1188,200,1388,183,42,225,1371,242,1613
2015,Land Management Engineering/Landscape Design,2198,2565,4763,116,241,357,2314,2806,5120
2015,Landscape Ecology/Biogeography (ex. SF385 s. 2012),504,736,1240,16,28,44,520,764,1284
2015,Latin,1444,1957,3401,33,74,107,1477,2031,3508
2015,Latin America Studies,150,374,524,36,67,103,186,441,627
2015,Food Chemistry,737,1656,2393,35,122,157,772,1778,2550
2015,Food Technology,1806,2435,4241,124,199,323,1930,2634,4564
2015,Area of study: Humanities,550,3306,3856,4,89,93,554,3395,3949
2015,Area of study: Social Studies,190,222,412,2,15,17,192,237,429
2015,Area of study: Natural Sciences/General Studies,247,943,1190,1,36,37,248,979,1227
2015,Area of study: Technology,751,359,1110,24,31,55,775,390,1165
2015,Aeronautical and Aerospace Engineering,5332,695,6027,772,145,917,6104,840,6944
2015,Painting,184,209,393,83,124,207,267,333,600
2015,Mine Surveying,16,9,25,3,2,5,19,11,30
2015,Mechanical Engineering,90510,10350,100860,16259,2984,19243,106769,13334,120103
2015,Materials Engineering,514,126,640,133,62,195,647,188,835
2015,Math.Statistics/Prob.Calc. (class.w. SF312 s.2020),1160,957,2117,159,181,340,1319,1138,2457
2015,Mathematics,28587,25697,54284,2742,2355,5097,31329,28052,59381
2015,Mechatronics,13470,1034,14504,2935,383,3318,16405,1417,17822
2015,Media Informatics,10836,4535,15371,924,643,1567,11760,5178,16938
2015,Media Technology,3975,2524,6499,220,176,396,4195,2700,6895
2015,Media Economics/Media Management,3116,5122,8238,202,428,630,3318,5550,8868
2015,Media Science,3693,7101,10794,324,916,1240,4017,8017,12034
2015,Medicine (General Medicine),30329,48586,78915,5031,6052,11083,35360,54638,89998
2015,Medical Informatics,1296,908,2204,251,320,571,1547,1228,2775
2015,Metals Technology,622,114,736,8,6,14,630,120,750
2015,Meteorology,874,676,1550,66,77,143,940,753,1693
2015,Microelectronics,137,8,145,129,28,157,266,36,302
2015,Microsystems Technology,1454,239,1693,932,225,1157,2386,464,2850
2015,Dairy Farming,43,53,96,9,10,19,52,63,115
2015,Mineralogy,46,25,71,35,17,52,81,42,123
2015,Medieval and Modern History,584,450,1034,51,51,102,635,501,1136
2015,Music Education,3314,4155,7469,223,455,678,3537,4610,8147
2015,Musicology/History of Music,2448,2525,4973,291,515,806,2739,3040,5779
2015,Nature Conservation,237,430,667,99,123,222,336,553,889
2015,Nautical Science/Maritime Studies,949,199,1148,51,8,59,1000,207,1207
2015,New Media,920,804,1724,160,176,336,1080,980,2060
2015,Modern Greek,9,22,31,19,57,76,28,79,107
2015,Non-medical Healthcare Professions/Therapies,2036,7480,9516,359,686,1045,2395,8166,10561
2015,Low German,1,8,9,,,,1,8,9
2015,Dutch,166,335,501,15,36,51,181,371,552
2015,"Nordic/Scand. St. (Nord. Phil., ind. lang. n.e.c.)",380,1174,1554,32,103,135,412,1277,1689
2015,Optoelectronics,543,154,697,107,41,148,650,195,845
2015,Orchestral Music,403,413,816,437,526,963,840,939,1779
2015,"Oriental Studies, Ancient Oriental Studies",664,915,1579,134,198,332,798,1113,1911
2015,Eastern and South Eastern Europe Studies,231,380,611,59,144,203,290,524,814
2015,Oceanography,12,13,25,4,3,7,16,16,32
2015,Early Childhood Education,274,1966,2240,11,91,102,285,2057,2342
2015,Plant Production,387,320,707,25,15,40,412,335,747
2015,Nursing Science/Nursing Management,2820,8496,11316,84,405,489,2904,8901,11805
2015,Pharmacy,4080,9388,13468,726,1354,2080,4806,10742,15548
2015,Philosophy,8874,6677,15551,1314,1105,2419,10188,7782,17970
2015,Physics,31520,11318,42838,3846,1791,5637,35366,13109,48475
2015,Engineering Physics/Mechanical Process Engineering,3075,709,3784,735,190,925,3810,899,4709
2015,Political Science,15286,10670,25956,1978,2514,4492,17264,13184,30448
2015,Police/Protection of the Constitution,10203,4827,15030,68,21,89,10271,4848,15119
2015,Polish,34,86,120,6,31,37,40,117,157
2015,Portuguese,23,70,93,11,30,41,34,100,134
2015,Psychology,16929,49321,66250,1126,3903,5029,18055,53224,71279
2015,Spatial Planning,2372,2395,4767,470,559,1029,2842,2954,5796
2015,Administration of Justice,500,1565,2065,,,,500,1565,2065
2015,Law,46695,55185,101880,3668,6723,10391,50363,61908,112271
2015,Renewable Energy,836,183,1019,175,65,240,1011,248,1259
2015,Religious Studies,685,1193,1878,109,151,260,794,1344,2138
2015,Restoration Studies,190,796,986,17,57,74,207,853,1060
2015,Rhythmics,3,34,37,2,4,6,5,38,43
2015,"Romance Studies (Rom. Phil., indiv. lang. n.e.c.)",693,2906,3599,270,1060,1330,963,3966,4929
2015,Russian,288,699,987,57,294,351,345,993,1338
2015,General Studies (including School Garden),46,230,276,2,4,6,48,234,282
2015,Drama Studies,255,242,497,39,21,60,294,263,557
2015,Naval Architecture/Ship Technology,762,133,895,180,24,204,942,157,1099
2015,School Pedagogy,345,634,979,35,40,75,380,674,1054
2015,Sinology/Korean Studies,1112,1703,2815,180,492,672,1292,2195,3487
2015,Slavic Studies (Slavic Philology),460,1028,1488,139,684,823,599,1712,2311
2015,Special Needs Education,2376,12524,14900,34,296,330,2410,12820,15230
2015,Other subjects,722,1081,1803,958,1023,1981,1680,2104,3784
2015,Other regional studies,206,287,493,58,141,199,264,428,692
2015,Sorabistics,6,23,29,,2,2,6,25,31
2015,Social Work,9776,31047,40823,479,1905,2384,10255,32952,43207
2015,Social Studies,1537,1422,2959,58,88,146,1595,1510,3105
2015,Social Pedagogy,1341,6080,7421,35,213,248,1376,6293,7669
2015,Social Security Administration,515,1106,1621,13,12,25,528,1118,1646
2015,Applied Social Science,5021,17002,22023,213,893,1106,5234,17895,23129
2015,Social Sciences,7791,10703,18494,750,1449,2199,8541,12152,20693
2015,Sociology,6643,10666,17309,516,1309,1825,7159,11975,19134
2015,Spanish,1165,4156,5321,245,687,932,1410,4843,6253
2015,Sports Management/Sports Economics,3059,1178,4237,159,56,215,3218,1234,4452
2015,Sports Education/Sports Psychology,5770,4002,9772,246,150,396,6016,4152,10168
2015,Sports Science,10603,6141,16744,586,273,859,11189,6414,17603
2015,Steel Construction,51,4,55,1,1,2,52,5,57
2015,Foundation Course,,,,40,21,61,40,21,61
2015,"South Slavic (Bulgar., Serbo-Croat., Slovene etc.)",12,20,32,3,8,11,15,28,43
2015,Dance Education,52,129,181,55,146,201,107,275,382
2015,Technical Cybernetics,439,99,538,44,14,58,483,113,596
2015,Technomathematics,1458,462,1920,87,54,141,1545,516,2061
2015,Textile Design,373,3106,3479,70,476,546,443,3582,4025
2015,Textile and Clothing Technology/Industry,400,2675,3075,185,320,505,585,2995,3580
2015,Theatre Studies,764,2231,2995,77,302,379,841,2533,3374
2015,Veterinary Medicine,1079,6385,7464,191,412,603,1270,6797,8067
2015,Animal Production,83,250,333,18,19,37,101,269,370
2015,Sound Engineering,432,50,482,32,14,46,464,64,528
2015,Tourism Management,1507,6726,8233,259,764,1023,1766,7490,9256
2015,Transport and Conveying Technology,403,32,435,43,4,47,446,36,482
2015,Czech,8,16,24,,11,11,8,27,35
2015,Turkish Studies,80,270,350,71,134,205,151,404,555
2015,Environmental Protection,1228,1240,2468,369,261,630,1597,1501,3098
2015,Environmental Technology (including Recycling),5614,2831,8445,641,552,1193,6255,3383,9638
2015,Prehistory and Early History,486,577,1063,38,52,90,524,629,1153
2015,Process Engineering,6430,3485,9915,921,761,1682,7351,4246,11597
2015,Transport Engineering,3852,1109,4961,494,214,708,4346,1323,5669
2015,Transport Economics,1366,666,2032,172,138,310,1538,804,2342
2015,Surveying (Geodesy),3598,1438,5036,618,333,951,4216,1771,5987
2015,Supply Technology,3214,427,3641,215,79,294,3429,506,3935
2015,Administrative Science/Public Administration,5460,7267,12727,284,407,691,5744,7674,13418
2015,Folklore,450,1368,1818,35,128,163,485,1496,1981
2015,Economics,13780,6231,20011,2180,2314,4494,15960,8545,24505
2015,Hydraulic Engineering,769,431,1200,106,99,205,875,530,1405
2015,Water Management,858,450,1308,270,182,452,1128,632,1760
2015,Viticulture and Oenology,637,327,964,109,58,167,746,385,1131
2015,Handicrafts (technical)/Technology,138,235,373,3,17,20,141,252,393
2015,Handicrafts Education,20,71,91,1,1,2,21,72,93
2015,Materials Technology,4617,1356,5973,942,522,1464,5559,1878,7437
2015,Western Slavic (general and n.e.c.),24,36,60,4,15,19,28,51,79
2015,Economic/Social Geography,256,241,497,8,14,22,264,255,519
2015,Economic/Social History,106,117,223,6,11,17,112,128,240
2015,Business Informatics,39110,8491,47601,4293,2625,6918,43403,11116,54519
2015,Business Engineering spec. in Engineering Sciences,46224,11393,57617,5136,2739,7875,51360,14132,65492
2015,Business Engineering specialising in Economics,25733,8198,33931,2847,1535,4382,28580,9733,38313
2015,Business Mathematics,4597,2998,7595,551,693,1244,5148,3691,8839
2015,Business and Economics Education,2639,4603,7242,82,249,331,2721,4852,7573
2015,Business Law,8752,10396,19148,633,1027,1660,9385,11423,20808
2015,Business and Economics,45751,34334,80085,4557,6016,10573,50308,40350,90658
2015,History of Science/History of Technology,34,14,48,4,4,8,38,18,56
2015,Dentistry,4437,8496,12933,974,1178,2152,5411,9674,15085
2015,Customs and Tax Administration,1981,2536,4517,1,5,6,1982,2541,4523
2016,Waste Management,68,27,95,3,,3,71,27,98
2016,African Studies,406,725,1131,156,198,354,562,923,1485
2016,Agricultural Biology,136,156,292,158,121,279,294,277,571
2016,Agricultural Economics,843,628,1471,284,228,512,1127,856,1983
2016,Agricultural Science/Agriculture,7979,7570,15549,1083,1016,2099,9062,8586,17648
2016,Egyptology,230,355,585,53,71,124,283,426,709
2016,General Linguistics/Indo-European Studies,1312,4048,5360,276,948,1224,1588,4996,6584
2016,General Literary Studies,859,2993,3852,155,504,659,1014,3497,4511
2016,Ancient History,111,80,191,17,20,37,128,100,228
2016,American Studies,913,1923,2836,268,570,838,1181,2493,3674
2016,Applied Art,1388,2336,3724,228,367,595,1616,2703,4319
2016,Applied Linguistics,948,3985,4933,198,850,1048,1146,4835,5981
2016,Applied Systems Science,1713,409,2122,448,152,600,2161,561,2722
2016,English Studies,12054,29363,41417,1333,3918,5251,13387,33281,46668
2016,Anthropology (Human Biology),126,356,482,72,105,177,198,461,659
2016,Arabic/Arabic Studies,210,374,584,66,62,128,276,436,712
2016,Work Studies/Business Studies,675,1036,1711,22,74,96,697,1110,1807
2016,Occupational Guidance and Career Counselling,80,252,332,,3,3,80,255,335
2016,Labour Administration,273,779,1052,5,7,12,278,786,1064
2016,Archaeology,2384,2829,5213,188,274,462,2572,3103,5675
2016,Archaeometry (Archaeological Engineering),22,9,31,1,2,3,23,11,34
2016,Architecture,13981,16431,30412,3011,4332,7343,16992,20763,37755
2016,Archive and Documentation Science,119,210,329,12,37,49,131,247,378
2016,Archive Studies,90,139,229,2,12,14,92,151,243
2016,Asian Languages and Cultures/Asian Studies,571,1133,1704,196,418,614,767,1551,2318
2016,Astrophysics and Astronomy,193,64,257,124,80,204,317,144,461
2016,Ophthalmic Optics,225,486,711,32,34,66,257,520,777
2016,Immigrant Education,14,111,125,29,41,70,43,152,195
2016,Non-Europ. Lang. and Cult. in Oceania and America,79,155,234,33,86,119,112,241,353
2016,Foreign Affairs Administration,61,148,209,,,,61,148,209
2016,Baltic Studies,4,5,9,,2,2,4,7,11
2016,Banking,370,253,623,4,7,11,374,260,634
2016,Civil Engineering/Structural Engineering,33017,13316,46333,6315,2727,9042,39332,16043,55375
2016,Mining/Mine Engineering,1152,171,1323,492,119,611,1644,290,1934
2016,Occupation-specific Foreign Language Training,453,1161,1614,84,262,346,537,1423,1960
2016,"Vocational, Business and Economics Education",653,839,1492,35,51,86,688,890,1578
2016,Business Administration,111891,100579,212470,11195,14440,25635,123086,115019,238105
2016,Librarianship,9,35,44,,,,9,35,44
2016,Fine Arts/Graphics,1261,1665,2926,416,717,1133,1677,2382,4059
2016,Sculpting/Statuary Art,120,131,251,60,110,170,180,241,421
2016,Biochemistry,3152,3924,7076,482,665,1147,3634,4589,8223
2016,Bioinformatics,1281,712,1993,215,204,419,1496,916,2412
2016,Biology,16828,29391,46219,2469,3952,6421,19297,33343,52640
2016,Biomedicine,549,1105,1654,251,320,571,800,1425,2225
2016,Biotechnology,5085,6096,11181,591,766,1357,5676,6862,12538
2016,Brewing Science/Beverage Technology,572,126,698,51,34,85,623,160,783
2016,Armed Forces Administration,186,202,388,,,,186,202,388
2016,Byzantine Studies,9,19,28,13,10,23,22,29,51
2016,Caritas Science,56,88,144,8,11,19,64,99,163
2016,Chemistry,24919,15319,40238,3019,3036,6055,27938,18355,46293
2016,Chemical Engineering/Chemical Process Technology,5656,2700,8356,921,767,1688,6577,3467,10044
2016,Computer Linguistics,740,582,1322,216,329,545,956,911,1867
2016,Computer and Communication Technology,2422,1453,3875,1026,399,1425,3448,1852,5300
2016,Danish,17,53,70,,1,1,17,54,71
2016,Performing Arts/Stagecraft/Directing,317,783,1100,150,297,447,467,1080,1547
2016,German as a Foreign or Second Language,541,2724,3265,464,1630,2094,1005,4354,5359
2016,Pastoral Care Studies,80,188,268,9,14,23,89,202,291
2016,Conducting,96,64,160,101,75,176,197,139,336
2016,Printing and Reproduction Technology,857,832,1689,128,133,261,985,965,1950
2016,Gemstone and Jewellery Design,7,74,81,3,31,34,10,105,115
2016,Electrical Power Engineering,2387,426,2813,546,148,694,2933,574,3507
2016,Electrical Engineering/Electronics,46837,5196,52033,14102,3382,17484,60939,8578,69517
2016,Energy Process Engineering,5835,1353,7188,989,347,1336,6824,1700,8524
2016,Nutritional Science,453,2562,3015,61,256,317,514,2818,3332
2016,Adult Education and Extracurricular Youth Educat.,557,1888,2445,28,118,146,585,2006,2591
2016,Educational Science (Pedagogy),13217,47708,60925,777,3704,4481,13994,51412,65406
2016,Ethics,343,710,1053,24,65,89,367,775,1142
2016,Ethnology,1209,3202,4411,183,416,599,1392,3618,5010
2016,European Ethnology and Cultural Studies,669,2158,2827,165,411,576,834,2569,3403
2016,European Economic Studies,1501,1843,3344,105,220,325,1606,2063,3669
2016,"Protestant Religious Pedagogy, Church Educat. Work",214,528,742,7,5,12,221,533,754
2016,"Protestant Theology, Protes. Religious Education",4825,7111,11936,371,284,655,5196,7395,12591
2016,Facility Management,1867,1268,3135,74,81,155,1941,1349,3290
2016,Automotive Technology,10808,734,11542,2167,265,2432,12975,999,13974
2016,Precision Engineering,507,34,541,66,10,76,573,44,617
2016,Manufacturing Technology/Production Engineering,5565,852,6417,1446,271,1717,7011,1123,8134
2016,Film and Television Studies,1361,1018,2379,168,228,396,1529,1246,2775
2016,Financial Administration,779,1050,1829,1,1,2,780,1051,1831
2016,Finno-Ugrian Studies,52,121,173,11,12,23,63,133,196
2016,"Forest Science, Forestry",3689,1841,5530,437,384,821,4126,2225,6351
2016,French,1115,5093,6208,180,650,830,1295,5743,7038
2016,Horticulture,1106,797,1903,86,75,161,1192,872,2064
2016,Geography,10548,9778,20326,578,617,1195,11126,10395,21521
2016,Geology/Palaeontology,332,175,507,158,97,255,490,272,762
2016,Geoecology,558,698,1256,46,50,96,604,748,1352
2016,Geophysics,1172,1033,2205,130,73,203,1302,1106,2408
2016,Geosciences general,6524,4115,10639,809,592,1401,7333,4707,12040
2016,German Studies/German,15621,51214,66835,1688,6357,8045,17309,57571,74880
2016,Singing,269,504,773,267,387,654,536,891,1427
2016,History,18918,14399,33317,1246,1563,2809,20164,15962,36126
2016,Health Education,540,2447,2987,7,69,76,547,2516,3063
2016,Health Technology,5369,4495,9864,1182,896,2078,6551,5391,11942
2016,Health Science/Health Management,10905,24757,35662,707,1659,2366,11612,26416,38028
2016,Glass Technology/Ceramics,157,56,213,11,9,20,168,65,233
2016,Graphic Design/Communication Design,6506,10098,16604,866,1671,2537,7372,11769,19141
2016,Greek,223,211,434,48,74,122,271,285,556
2016,Primary School Education/Primary Level Education,880,5451,6331,19,118,137,899,5569,6468
2016,Domestic and Nutritional Sciences,1436,6481,7917,140,415,555,1576,6896,8472
2016,Domestic Science,38,118,156,,4,4,38,122,160
2016,Wood and Fibre Technology,922,163,1085,50,23,73,972,186,1158
2016,Timber Construction,670,117,787,20,3,23,690,120,810
2016,Wood Science,369,97,466,26,15,41,395,112,507
2016,Metallurgy and Foundry,671,240,911,271,123,394,942,363,1305
2016,Indology,65,124,189,18,20,38,83,144,227
2016,Industrial Design/Product Design,1737,1506,3243,270,358,628,2007,1864,3871
2016,Computer Science,76858,15258,92116,13303,4689,17992,90161,19947,110108
2016,Inf./Library Scien. (not at univ. of app.adm.sci.),686,2137,2823,38,153,191,724,2290,3014
2016,Computational Engineer./Technical Computer Science,8472,1264,9736,1941,492,2433,10413,1756,12169
2016,Interior Architecture,424,2726,3150,68,339,407,492,3065,3557
2016,Internal Administration,1994,3790,5784,26,64,90,2020,3854,5874
2016,Instrumental Music,1255,1163,2418,1941,2465,4406,3196,3628,6824
2016,Interdisc. Studies (specialising in Engineering),10902,3630,14532,1878,862,2740,12780,4492,17272
2016,Interdisc. Studies (special. in Natural Sciences),2906,2624,5530,772,579,1351,3678,3203,6881
2016,"Interdisc. St. (spec. in Law, Econ. and Soc. Sci.)",5756,7017,12773,786,1235,2021,6542,8252,14794
2016,Interdisc. Studies (spec. in Humanities),5408,13996,19404,986,2663,3649,6394,16659,23053
2016,"Interdisc. Studies (special. in Art, Art Theory)",317,711,1028,53,130,183,370,841,1211
2016,International Business Studies/Management,16130,20013,36143,5175,5981,11156,21305,25994,47299
2016,Iranian Studies,71,101,172,27,45,72,98,146,244
2016,Islamic Studies/Islamic theology,148,276,424,57,132,189,205,408,613
2016,Islamic Studies,638,1215,1853,197,277,474,835,1492,2327
2016,Italian,225,837,1062,100,370,470,325,1207,1532
2016,Japanese Studies,1421,1801,3222,145,288,433,1566,2089,3655
2016,Jazz and Popular Music,875,269,1144,153,65,218,1028,334,1362
2016,Judaic Studies/Hebrew,230,404,634,36,64,100,266,468,734
2016,Law Enforcement,62,62,124,,,,62,62,124
2016,Cartography,167,77,244,66,77,143,233,154,387
2016,"Catholic Religious Pedagogy, Church Educat. Work",114,261,375,1,9,10,115,270,385
2016,"Catholic Theology, Catholic Religious Education",3360,4200,7560,468,195,663,3828,4395,8223
2016,Caucasian Studies,1,2,3,1,2,3,2,4,6
2016,Nucl.Techn./Nucl.Process Techn.(cl.w.SF211 s.2020),2,,2,4,,4,6,,6
2016,Church Music,258,124,382,41,63,104,299,187,486
2016,Classical Philology,246,259,505,55,54,109,301,313,614
2016,"Communication Technology, Information Engineering",5144,775,5919,2105,531,2636,7249,1306,8555
2016,Communication Science/Journalism,5296,11671,16967,368,1267,1635,5664,12938,18602
2016,Composition,144,35,179,105,92,197,249,127,376
2016,Arts Education,946,4112,5058,104,332,436,1050,4444,5494
2016,"Art History, Art Theory",2010,8223,10233,241,1161,1402,2251,9384,11635
2016,Plastics Technology,1128,202,1330,210,45,255,1338,247,1585
2016,Land Management Engineering/Landscape Design,2258,2643,4901,109,220,329,2367,2863,5230
2016,Landscape Ecology/Biogeography (ex. SF385 s. 2012),497,771,1268,17,39,56,514,810,1324
2016,Latin,1400,1779,3179,34,72,106,1434,1851,3285
2016,Latin America Studies,146,344,490,39,73,112,185,417,602
2016,Food Chemistry,744,1704,2448,38,144,182,782,1848,2630
2016,Food Technology,1794,2459,4253,131,200,331,1925,2659,4584
2016,Area of study: Humanities,646,3743,4389,10,102,112,656,3845,4501
2016,Area of study: Social Studies,195,209,404,4,14,18,199,223,422
2016,Area of study: Natural Sciences/General Studies,310,1300,1610,2,32,34,312,1332,1644
2016,Area of study: Technology,737,389,1126,23,24,47,760,413,1173
2016,Aeronautical and Aerospace Engineering,5468,711,6179,849,173,1022,6317,884,7201
2016,Painting,181,222,403,111,158,269,292,380,672
2016,Mine Surveying,18,8,26,6,10,16,24,18,42
2016,Mechanical Engineering,87979,10475,98454,17161,3077,20238,105140,13552,118692
2016,Materials Engineering,853,279,1132,307,173,480,1160,452,1612
2016,Math.Statistics/Prob.Calc. (class.w. SF312 s.2020),1234,1017,2251,164,203,367,1398,1220,2618
2016,Mathematics,28752,25852,54604,2840,2523,5363,31592,28375,59967
2016,Mechatronics,13253,1144,14397,3325,436,3761,16578,1580,18158
2016,Media Informatics,11070,4922,15992,999,724,1723,12069,5646,17715
2016,Media Technology,4108,2538,6646,242,202,444,4350,2740,7090
2016,Media Economics/Media Management,3135,5339,8474,251,501,752,3386,5840,9226
2016,Media Science,3821,7520,11341,347,975,1322,4168,8495,12663
2016,Medicine (General Medicine),30560,49827,80387,5205,6419,11624,35765,56246,92011
2016,Medical Informatics,1314,940,2254,267,348,615,1581,1288,2869
2016,Metals Technology,683,125,808,10,7,17,693,132,825
2016,Meteorology,810,655,1465,76,79,155,886,734,1620
2016,Microelectronics,119,8,127,127,35,162,246,43,289
2016,Microsystems Technology,1434,229,1663,999,238,1237,2433,467,2900
2016,Dairy Farming,33,47,80,8,10,18,41,57,98
2016,Mineralogy,38,16,54,36,21,57,74,37,111
2016,Medieval and Modern History,533,428,961,49,45,94,582,473,1055
2016,Music Education,3287,4109,7396,236,497,733,3523,4606,8129
2016,Musicology/History of Music,2357,2458,4815,280,538,818,2637,2996,5633
2016,Nature Conservation,230,449,679,92,131,223,322,580,902
2016,Nautical Science/Maritime Studies,856,195,1051,64,9,73,920,204,1124
2016,New Media,921,816,1737,173,195,368,1094,1011,2105
2016,Modern Greek,19,20,39,18,62,80,37,82,119
2016,Non-medical Healthcare Professions/Therapies,2027,7700,9727,347,720,1067,2374,8420,10794
2016,Low German,2,6,8,,,,2,6,8
2016,Dutch,113,255,368,14,35,49,127,290,417
2016,"Nordic/Scand. St. (Nord. Phil., ind. lang. n.e.c.)",366,1046,1412,29,95,124,395,1141,1536
2016,Optoelectronics,559,164,723,113,34,147,672,198,870
2016,Orchestral Music,499,459,958,467,550,1017,966,1009,1975
2016,"Oriental Studies, Ancient Oriental Studies",655,936,1591,136,211,347,791,1147,1938
2016,Eastern and South Eastern Europe Studies,221,371,592,73,142,215,294,513,807
2016,Oceanography,5,8,13,11,7,18,16,15,31
2016,Early Childhood Education,298,2413,2711,12,106,118,310,2519,2829
2016,Plant Production,422,343,765,28,15,43,450,358,808
2016,Nursing Science/Nursing Management,2820,8690,11510,102,419,521,2922,9109,12031
2016,Pharmacy,4157,9377,13534,737,1411,2148,4894,10788,15682
2016,Philosophy,9072,6816,15888,1264,1114,2378,10336,7930,18266
2016,Physics,31760,12117,43877,4181,1973,6154,35941,14090,50031
2016,Engineering Physics/Mechanical Process Engineering,2803,635,3438,754,182,936,3557,817,4374
2016,Political Science,15279,10812,26091,1983,2564,4547,17262,13376,30638
2016,Police/Protection of the Constitution,11179,5363,16542,83,26,109,11262,5389,16651
2016,Polish,32,77,109,8,34,42,40,111,151
2016,Portuguese,30,71,101,13,24,37,43,95,138
2016,Psychology,18048,52127,70175,1187,4086,5273,19235,56213,75448
2016,Spatial Planning,2309,2424,4733,453,595,1048,2762,3019,5781
2016,Administration of Justice,527,1630,2157,,,,527,1630,2157
2016,Law,47212,56440,103652,3679,6672,10351,50891,63112,114003
2016,Renewable Energy,854,179,1033,179,80,259,1033,259,1292
2016,Religious Studies,678,1249,1927,131,165,296,809,1414,2223
2016,Restoration Studies,165,757,922,24,69,93,189,826,1015
2016,Rhythmics,1,27,28,,1,1,1,28,29
2016,"Romance Studies (Rom. Phil., indiv. lang. n.e.c.)",667,2572,3239,248,953,1201,915,3525,4440
2016,Russian,284,650,934,51,287,338,335,937,1272
2016,General Studies (including School Garden),55,288,343,3,12,15,58,300,358
2016,Drama Studies,255,247,502,51,25,76,306,272,578
2016,Naval Architecture/Ship Technology,719,134,853,199,33,232,918,167,1085
2016,School Pedagogy,310,556,866,33,51,84,343,607,950
2016,Sinology/Korean Studies,995,1705,2700,192,541,733,1187,2246,3433
2016,Slavic Studies (Slavic Philology),454,985,1439,120,641,761,574,1626,2200
2016,Special Needs Education,2249,11892,14141,36,270,306,2285,12162,14447
2016,Other subjects,863,1048,1911,842,914,1756,1705,1962,3667
2016,Other regional studies,142,233,375,37,82,119,179,315,494
2016,Sorabistics,8,20,28,1,6,7,9,26,35
2016,Social Work,10685,33819,44504,578,2202,2780,11263,36021,47284
2016,Social Studies,1586,1442,3028,72,92,164,1658,1534,3192
2016,Social Pedagogy,1512,6661,8173,38,239,277,1550,6900,8450
2016,Social Security Administration,500,1099,1599,34,33,67,534,1132,1666
2016,Applied Social Science,5268,17621,22889,256,944,1200,5524,18565,24089
2016,Social Sciences,7939,11062,19001,778,1504,2282,8717,12566,21283
2016,Sociology,6518,10789,17307,569,1335,1904,7087,12124,19211
2016,Spanish,1276,4060,5336,250,723,973,1526,4783,6309
2016,Sports Management/Sports Economics,3316,1288,4604,190,64,254,3506,1352,4858
2016,Sports Education/Sports Psychology,5611,3821,9432,223,139,362,5834,3960,9794
2016,Sports Science,10774,6346,17120,613,295,908,11387,6641,18028
2016,Steel Construction,59,7,66,3,,3,62,7,69
2016,"South Slavic (Bulgar., Serbo-Croat., Slovene etc.)",7,20,27,2,5,7,9,25,34
2016,Dance Education,28,126,154,60,137,197,88,263,351
2016,Technical Cybernetics,419,102,521,49,16,65,468,118,586
2016,Technomathematics,1509,492,2001,100,68,168,1609,560,2169
2016,Textile Design,361,2825,3186,85,475,560,446,3300,3746
2016,Textile and Clothing Technology/Industry,416,2588,3004,187,338,525,603,2926,3529
2016,Theatre Studies,800,2205,3005,78,313,391,878,2518,3396
2016,Veterinary Medicine,1083,6323,7406,190,434,624,1273,6757,8030
2016,Animal Production,89,259,348,18,22,40,107,281,388
2016,Sound Engineering,476,66,542,36,18,54,512,84,596
2016,Tourism Management,1435,6185,7620,270,765,1035,1705,6950,8655
2016,Transport and Conveying Technology,400,37,437,36,11,47,436,48,484
2016,Czech,8,20,28,1,11,12,9,31,40
2016,Turkish Studies,82,259,341,59,129,188,141,388,529
2016,Environmental Protection,907,967,1874,374,265,639,1281,1232,2513
2016,Environmental Technology (including Recycling),5337,2727,8064,721,596,1317,6058,3323,9381
2016,Prehistory and Early History,471,558,1029,39,57,96,510,615,1125
2016,Process Engineering,6273,3421,9694,965,800,1765,7238,4221,11459
2016,Transport Engineering,3723,1165,4888,467,197,664,4190,1362,5552
2016,Transport Economics,1307,604,1911,201,151,352,1508,755,2263
2016,Surveying (Geodesy),3635,1476,5111,693,375,1068,4328,1851,6179
2016,Supply Technology,3161,448,3609,225,83,308,3386,531,3917
2016,Administrative Science/Public Administration,5743,7444,13187,260,393,653,6003,7837,13840
2016,Folklore,378,1040,1418,19,101,120,397,1141,1538
2016,Economics,13885,6169,20054,2284,2475,4759,16169,8644,24813
2016,Hydraulic Engineering,780,421,1201,106,116,222,886,537,1423
2016,Water Management,791,422,1213,278,170,448,1069,592,1661
2016,Viticulture and Oenology,734,402,1136,112,94,206,846,496,1342
2016,Handicrafts (technical)/Technology,146,235,381,3,19,22,149,254,403
2016,Handicrafts Education,19,72,91,1,1,2,20,73,93
2016,Materials Technology,4066,1190,5256,862,446,1308,4928,1636,6564
2016,Western Slavic (general and n.e.c.),27,33,60,1,17,18,28,50,78
2016,Economic/Social Geography,273,274,547,12,22,34,285,296,581
2016,Economic/Social History,94,107,201,5,17,22,99,124,223
2016,Business Informatics,40375,8993,49368,4588,2827,7415,44963,11820,56783
2016,Business Engineering spec. in Engineering Sciences,47346,11805,59151,5772,3075,8847,53118,14880,67998
2016,Business Engineering specialising in Economics,24742,8124,32866,2916,1566,4482,27658,9690,37348
2016,Business Mathematics,4532,3047,7579,599,757,1356,5131,3804,8935
2016,Business and Economics Education,2559,4398,6957,82,249,331,2641,4647,7288
2016,Business Law,9082,11005,20087,646,1133,1779,9728,12138,21866
2016,Business and Economics,45996,34374,80370,4822,6194,11016,50818,40568,91386
2016,History of Science/History of Technology,30,9,39,4,4,8,34,13,47
2016,Dentistry,4389,8547,12936,983,1178,2161,5372,9725,15097
2016,Customs and Tax Administration,2038,2733,4771,1,6,7,2039,2739,4778
2017,Waste Management,75,40,115,5,4,9,80,44,124
2017,African Studies,395,782,1177,135,186,321,530,968,1498
2017,Agricultural Biology,149,173,322,164,111,275,313,284,597
2017,Agricultural Economics,856,656,1512,301,240,541,1157,896,2053
2017,Agricultural Science/Agriculture,7918,7410,15328,1062,1046,2108,8980,8456,17436
2017,Egyptology,230,342,572,52,66,118,282,408,690
2017,General Linguistics/Indo-European Studies,1313,4000,5313,306,1045,1351,1619,5045,6664
2017,General Literary Studies,849,2908,3757,124,436,560,973,3344,4317
2017,Ancient History,112,82,194,13,18,31,125,100,225
2017,American Studies,820,1779,2599,312,622,934,1132,2401,3533
2017,Applied Art,1342,2312,3654,205,344,549,1547,2656,4203
2017,Applied Linguistics,952,3966,4918,197,774,971,1149,4740,5889
2017,Applied Systems Science,1726,436,2162,472,171,643,2198,607,2805
2017,English Studies,12106,29679,41785,1357,3955,5312,13463,33634,47097
2017,Anthropology (Human Biology),122,336,458,79,124,203,201,460,661
2017,Arabic/Arabic Studies,209,395,604,72,69,141,281,464,745
2017,Work Studies/Business Studies,676,1070,1746,21,72,93,697,1142,1839
2017,Occupational Guidance and Career Counselling,111,317,428,,2,2,111,319,430
2017,Labour Administration,284,798,1082,5,6,11,289,804,1093
2017,Archaeology,2474,2847,5321,189,291,480,2663,3138,5801
2017,Archaeometry (Archaeological Engineering),25,10,35,1,2,3,26,12,38
2017,Architecture,13858,16425,30283,3054,4386,7440,16912,20811,37723
2017,Archive and Documentation Science,132,181,313,12,33,45,144,214,358
2017,Archive Studies,119,156,275,1,5,6,120,161,281
2017,Asian Languages and Cultures/Asian Studies,514,1107,1621,230,480,710,744,1587,2331
2017,Astrophysics and Astronomy,200,69,269,128,99,227,328,168,496
2017,Ophthalmic Optics,218,465,683,37,31,68,255,496,751
2017,Immigrant Education,17,120,137,39,62,101,56,182,238
2017,Non-Europ. Lang. and Cult. in Oceania and America,77,167,244,33,88,121,110,255,365
2017,Foreign Affairs Administration,72,153,225,,,,72,153,225
2017,Baltic Studies,5,5,10,,1,1,5,6,11
2017,Banking,406,266,672,5,5,10,411,271,682
2017,Civil Engineering/Structural Engineering,32865,13500,46365,6745,2847,9592,39610,16347,55957
2017,Mining/Mine Engineering,1068,165,1233,489,136,625,1557,301,1858
2017,Occupation-specific Foreign Language Training,435,1208,1643,76,296,372,511,1504,2015
2017,"Vocational, Business and Economics Education",690,811,1501,31,47,78,721,858,1579
2017,Business Administration,112406,101539,213945,11703,14924,26627,124109,116463,240572
2017,Librarianship,14,38,52,,,,14,38,52
2017,Fine Arts/Graphics,1263,1652,2915,419,738,1157,1682,2390,4072
2017,Sculpting/Statuary Art,104,118,222,67,113,180,171,231,402
2017,Biochemistry,3164,4097,7261,550,757,1307,3714,4854,8568
2017,Bioinformatics,1355,784,2139,250,269,519,1605,1053,2658
2017,Biology,16879,29429,46308,2595,4181,6776,19474,33610,53084
2017,Biomedicine,570,1187,1757,267,351,618,837,1538,2375
2017,Biotechnology,4986,6150,11136,690,889,1579,5676,7039,12715
2017,Brewing Science/Beverage Technology,596,118,714,57,25,82,653,143,796
2017,Armed Forces Administration,221,231,452,3,,3,224,231,455
2017,Byzantine Studies,5,16,21,12,8,20,17,24,41
2017,Caritas Science,57,84,141,7,12,19,64,96,160
2017,Chemistry,24630,15257,39887,3055,3090,6145,27685,18347,46032
2017,Chemical Engineering/Chemical Process Technology,5418,2570,7988,979,800,1779,6397,3370,9767
2017,Computer Linguistics,740,567,1307,192,318,510,932,885,1817
2017,Computer and Communication Technology,2616,1661,4277,1084,457,1541,3700,2118,5818
2017,Danish,10,54,64,,,,10,54,64
2017,Performing Arts/Stagecraft/Directing,357,817,1174,150,256,406,507,1073,1580
2017,German as a Foreign or Second Language,575,2689,3264,504,1641,2145,1079,4330,5409
2017,Pastoral Care Studies,65,158,223,8,12,20,73,170,243
2017,Conducting,96,57,153,105,65,170,201,122,323
2017,Printing and Reproduction Technology,770,805,1575,102,125,227,872,930,1802
2017,Gemstone and Jewellery Design,6,59,65,4,31,35,10,90,100
2017,Electrical Power Engineering,2178,420,2598,577,141,718,2755,561,3316
2017,Electrical Engineering/Electronics,45351,5331,50682,15215,3737,18952,60566,9068,69634
2017,Energy Process Engineering,5697,1306,7003,1109,375,1484,6806,1681,8487
2017,Nutritional Science,527,2823,3350,75,275,350,602,3098,3700
2017,Adult Education and Extracurricular Youth Educat.,583,1989,2572,29,126,155,612,2115,2727
2017,Educational Science (Pedagogy),12726,44169,56895,804,3624,4428,13530,47793,61323
2017,Ethics,341,706,1047,22,67,89,363,773,1136
2017,Ethnology,1191,3135,4326,204,426,630,1395,3561,4956
2017,European Ethnology and Cultural Studies,856,2488,3344,228,494,722,1084,2982,4066
2017,European Economic Studies,1122,1549,2671,120,192,312,1242,1741,2983
2017,"Protestant Religious Pedagogy, Church Educat. Work",205,519,724,5,2,7,210,521,731
2017,"Protestant Theology, Protes. Religious Education",4780,7067,11847,390,297,687,5170,7364,12534
2017,Facility Management,1918,1343,3261,64,82,146,1982,1425,3407
2017,Automotive Technology,10622,730,11352,2308,276,2584,12930,1006,13936
2017,Precision Engineering,503,40,543,93,16,109,596,56,652
2017,Manufacturing Technology/Production Engineering,5530,890,6420,1485,327,1812,7015,1217,8232
2017,Film and Television Studies,1426,1088,2514,182,210,392,1608,1298,2906
2017,Financial Administration,736,1056,1792,4,2,6,740,1058,1798
2017,Finno-Ugrian Studies,38,127,165,6,14,20,44,141,185
2017,"Forest Science, Forestry",3734,1935,5669,478,359,837,4212,2294,6506
2017,French,1080,4803,5883,172,610,782,1252,5413,6665
2017,Horticulture,1236,908,2144,88,103,191,1324,1011,2335
2017,Geography,10471,9806,20277,562,622,1184,11033,10428,21461
2017,Geology/Palaeontology,284,171,455,162,106,268,446,277,723
2017,Geoecology,577,705,1282,48,46,94,625,751,1376
2017,Geophysics,1061,948,2009,120,77,197,1181,1025,2206
2017,Geosciences general,6072,3934,10006,836,602,1438,6908,4536,11444
2017,German Studies/German,15212,51405,66617,1710,6020,7730,16922,57425,74347
2017,Singing,317,561,878,283,433,716,600,994,1594
2017,History,18765,14331,33096,1325,1584,2909,20090,15915,36005
2017,Health Education,646,2901,3547,13,92,105,659,2993,3652
2017,Health Technology,5020,4418,9438,1372,1059,2431,6392,5477,11869
2017,Health Science/Health Management,11641,26074,37715,833,1861,2694,12474,27935,40409
2017,Glass Technology/Ceramics,151,49,200,12,7,19,163,56,219
2017,Graphic Design/Communication Design,6491,10370,16861,964,1923,2887,7455,12293,19748
2017,Greek,222,196,418,50,62,112,272,258,530
2017,Primary School Education/Primary Level Education,1005,5960,6965,23,130,153,1028,6090,7118
2017,Domestic and Nutritional Sciences,1441,6403,7844,121,415,536,1562,6818,8380
2017,Domestic Science,38,157,195,1,2,3,39,159,198
2017,Wood and Fibre Technology,811,135,946,40,19,59,851,154,1005
2017,Timber Construction,688,129,817,28,8,36,716,137,853
2017,Wood Science,345,89,434,18,18,36,363,107,470
2017,Metallurgy and Foundry,566,202,768,286,135,421,852,337,1189
2017,Indology,60,126,186,16,25,41,76,151,227
2017,Industrial Design/Product Design,1747,1680,3427,276,379,655,2023,2059,4082
2017,Computer Science,79219,15954,95173,14680,5152,19832,93899,21106,115005
2017,Inf./Library Scien. (not at univ. of app.adm.sci.),681,2159,2840,49,163,212,730,2322,3052
2017,Computational Engineer./Technical Computer Science,9061,1342,10403,2186,552,2738,11247,1894,13141
2017,Interior Architecture,427,2769,3196,79,363,442,506,3132,3638
2017,Internal Administration,2213,4104,6317,26,69,95,2239,4173,6412
2017,Instrumental Music,1378,1288,2666,2019,2469,4488,3397,3757,7154
2017,Interdisc. Studies (specialising in Engineering),10919,3811,14730,2059,918,2977,12978,4729,17707
2017,Interdisc. Studies (special. in Natural Sciences),2787,2746,5533,823,646,1469,3610,3392,7002
2017,"Interdisc. St. (spec. in Law, Econ. and Soc. Sci.)",5947,7375,13322,859,1378,2237,6806,8753,15559
2017,Interdisc. Studies (spec. in Humanities),5204,13390,18594,1061,2566,3627,6265,15956,22221
2017,"Interdisc. Studies (special. in Art, Art Theory)",244,495,739,66,115,181,310,610,920
2017,International Business Studies/Management,15881,19663,35544,5366,6119,11485,21247,25782,47029
2017,Iranian Studies,83,102,185,27,43,70,110,145,255
2017,Islamic Studies/Islamic theology,137,275,412,60,122,182,197,397,594
2017,Islamic Studies,628,1212,1840,186,274,460,814,1486,2300
2017,Italian,229,715,944,98,340,438,327,1055,1382
2017,Japanese Studies,1489,1821,3310,159,312,471,1648,2133,3781
2017,Jazz and Popular Music,851,271,1122,157,77,234,1008,348,1356
2017,Judaic Studies/Hebrew,252,373,625,36,62,98,288,435,723
2017,Law Enforcement,85,82,167,,,,85,82,167
2017,Cartography,162,74,236,64,73,137,226,147,373
2017,"Catholic Religious Pedagogy, Church Educat. Work",117,242,359,2,12,14,119,254,373
2017,"Catholic Theology, Catholic Religious Education",3239,4033,7272,499,176,675,3738,4209,7947
2017,Caucasian Studies,1,,1,1,2,3,2,2,4
2017,Nucl.Techn./Nucl.Process Techn.(cl.w.SF211 s.2020),3,,3,1,,1,4,,4
2017,Church Music,265,135,400,40,60,100,305,195,500
2017,Classical Philology,237,236,473,44,59,103,281,295,576
2017,"Communication Technology, Information Engineering",4735,723,5458,2092,552,2644,6827,1275,8102
2017,Communication Science/Journalism,5404,11703,17107,381,1247,1628,5785,12950,18735
2017,Composition,142,33,175,133,99,232,275,132,407
2017,Arts Education,963,4161,5124,110,336,446,1073,4497,5570
2017,"Art History, Art Theory",2183,8403,10586,222,1176,1398,2405,9579,11984
2017,Plastics Technology,1130,222,1352,201,50,251,1331,272,1603
2017,Land Management Engineering/Landscape Design,2150,2563,4713,110,246,356,2260,2809,5069
2017,Landscape Ecology/Biogeography (ex. SF385 s. 2012),486,747,1233,19,35,54,505,782,1287
2017,Latin,1225,1580,2805,35,53,88,1260,1633,2893
2017,Latin America Studies,149,330,479,44,78,122,193,408,601
2017,Food Chemistry,722,1696,2418,46,134,180,768,1830,2598
2017,Food Technology,1753,2351,4104,153,226,379,1906,2577,4483
2017,Area of study: Humanities,807,4784,5591,33,195,228,840,4979,5819
2017,Area of study: Social Studies,222,227,449,4,11,15,226,238,464
2017,Area of study: Natural Sciences/General Studies,570,2714,3284,10,66,76,580,2780,3360
2017,Area of study: Technology,770,425,1195,23,23,46,793,448,1241
2017,Aeronautical and Aerospace Engineering,5582,744,6326,895,191,1086,6477,935,7412
2017,Painting,162,204,366,98,142,240,260,346,606
2017,Mine Surveying,16,8,24,3,2,5,19,10,29
2017,Mechanical Engineering,82595,10319,92914,17462,3115,20577,100057,13434,113491
2017,Materials Engineering,852,289,1141,311,163,474,1163,452,1615
2017,Math.Statistics/Prob.Calc. (class.w. SF312 s.2020),1167,942,2109,160,196,356,1327,1138,2465
2017,Mathematics,28542,26324,54866,3062,2550,5612,31604,28874,60478
2017,Mechatronics,12844,1187,14031,3822,515,4337,16666,1702,18368
2017,Media Informatics,11536,5250,16786,1093,765,1858,12629,6015,18644
2017,Media Technology,4125,2716,6841,247,229,476,4372,2945,7317
2017,Media Economics/Media Management,3285,5645,8930,251,529,780,3536,6174,9710
2017,Media Science,3814,7872,11686,359,925,1284,4173,8797,12970
2017,Medicine (General Medicine),30907,51092,81999,5274,6673,11947,36181,57765,93946
2017,Medical Informatics,1297,971,2268,310,342,652,1607,1313,2920
2017,Metals Technology,679,119,798,13,8,21,692,127,819
2017,Meteorology,752,608,1360,72,88,160,824,696,1520
2017,Microelectronics,159,8,167,159,45,204,318,53,371
2017,Microsystems Technology,1202,202,1404,981,234,1215,2183,436,2619
2017,Dairy Farming,45,40,85,7,12,19,52,52,104
2017,Mineralogy,36,11,47,43,17,60,79,28,107
2017,Medieval and Modern History,512,414,926,51,41,92,563,455,1018
2017,Music Education,3124,3849,6973,242,478,720,3366,4327,7693
2017,Musicology/History of Music,2339,2375,4714,295,532,827,2634,2907,5541
2017,Nature Conservation,230,468,698,94,154,248,324,622,946
2017,Nautical Science/Maritime Studies,665,177,842,116,23,139,781,200,981
2017,New Media,905,843,1748,201,215,416,1106,1058,2164
2017,Modern Greek,22,25,47,15,61,76,37,86,123
2017,Non-medical Healthcare Professions/Therapies,2200,8169,10369,242,553,795,2442,8722,11164
2017,Low German,2,6,8,,,,2,6,8
2017,Dutch,107,252,359,13,37,50,120,289,409
2017,"Nordic/Scand. St. (Nord. Phil., ind. lang. n.e.c.)",373,1005,1378,28,96,124,401,1101,1502
2017,Optoelectronics,445,136,581,94,34,128,539,170,709
2017,Orchestral Music,475,450,925,475,573,1048,950,1023,1973
2017,"Oriental Studies, Ancient Oriental Studies",577,905,1482,132,183,315,709,1088,1797
2017,Eastern and South Eastern Europe Studies,201,328,529,69,134,203,270,462,732
2017,Oceanography,12,7,19,8,6,14,20,13,33
2017,Early Childhood Education,309,2607,2916,10,149,159,319,2756,3075
2017,Plant Production,428,356,784,38,31,69,466,387,853
2017,Nursing Science/Nursing Management,2857,8910,11767,108,436,544,2965,9346,12311
2017,Pharmacy,4214,9450,13664,771,1459,2230,4985,10909,15894
2017,Philosophy,9307,6939,16246,1306,1229,2535,10613,8168,18781
2017,Physics,31934,12545,44479,4442,2068,6510,36376,14613,50989
2017,Engineering Physics/Mechanical Process Engineering,2538,581,3119,787,198,985,3325,779,4104
2017,Political Science,15880,11584,27464,2095,2711,4806,17975,14295,32270
2017,Police/Protection of the Constitution,13054,6350,19404,101,37,138,13155,6387,19542
2017,Polish,28,65,93,8,28,36,36,93,129
2017,Portuguese,32,75,107,8,18,26,40,93,133
2017,Psychology,19156,55929,75085,1263,4288,5551,20419,60217,80636
2017,Spatial Planning,2281,2434,4715,435,584,1019,2716,3018,5734
2017,Administration of Justice,582,1651,2233,,1,1,582,1652,2234
2017,Law,47628,58089,105717,3756,6744,10500,51384,64833,116217
2017,Renewable Energy,938,194,1132,245,95,340,1183,289,1472
2017,Religious Studies,688,1156,1844,113,168,281,801,1324,2125
2017,Restoration Studies,158,689,847,15,58,73,173,747,920
2017,Rhythmics,2,23,25,2,3,5,4,26,30
2017,"Romance Studies (Rom. Phil., indiv. lang. n.e.c.)",608,2341,2949,269,916,1185,877,3257,4134
2017,Russian,255,564,819,50,266,316,305,830,1135
2017,General Studies (including School Garden),79,372,451,1,16,17,80,388,468
2017,Drama Studies,245,254,499,50,27,77,295,281,576
2017,Naval Architecture/Ship Technology,741,141,882,204,43,247,945,184,1129
2017,School Pedagogy,263,512,775,36,56,92,299,568,867
2017,Sinology/Korean Studies,967,1676,2643,179,552,731,1146,2228,3374
2017,Slavic Studies (Slavic Philology),452,911,1363,108,582,690,560,1493,2053
2017,Special Needs Education,2328,12031,14359,39,266,305,2367,12297,14664
2017,Other subjects,1024,1270,2294,881,937,1818,1905,2207,4112
2017,Other regional studies,154,252,406,45,95,140,199,347,546
2017,Sorabistics,9,26,35,,3,3,9,29,38
2017,Social Work,12024,38084,50108,705,2445,3150,12729,40529,53258
2017,Social Studies,1521,1481,3002,84,100,184,1605,1581,3186
2017,Social Pedagogy,1471,6363,7834,42,241,283,1513,6604,8117
2017,Social Security Administration,526,1172,1698,62,52,114,588,1224,1812
2017,Applied Social Science,5425,18284,23709,275,961,1236,5700,19245,24945
2017,Social Sciences,8506,11784,20290,842,1522,2364,9348,13306,22654
2017,Sociology,6491,10933,17424,631,1357,1988,7122,12290,19412
2017,Spanish,1289,3821,5110,230,715,945,1519,4536,6055
2017,Sports Management/Sports Economics,3630,1356,4986,237,80,317,3867,1436,5303
2017,Sports Education/Sports Psychology,5473,3753,9226,196,117,313,5669,3870,9539
2017,Sports Science,11049,6642,17691,636,333,969,11685,6975,18660
2017,Steel Construction,56,6,62,4,,4,60,6,66
2017,"South Slavic (Bulgar., Serbo-Croat., Slovene etc.)",4,11,15,1,5,6,5,16,21
2017,Dance Education,30,134,164,75,153,228,105,287,392
2017,Technical Cybernetics,408,102,510,52,15,67,460,117,577
2017,Technomathematics,1550,529,2079,131,72,203,1681,601,2282
2017,Textile Design,381,2614,2995,62,396,458,443,3010,3453
2017,Textile and Clothing Technology/Industry,394,2388,2782,192,337,529,586,2725,3311
2017,Theatre Studies,800,2121,2921,79,298,377,879,2419,3298
2017,Veterinary Medicine,1077,6217,7294,176,476,652,1253,6693,7946
2017,Animal Production,89,254,343,20,20,40,109,274,383
2017,Sound Engineering,492,69,561,44,13,57,536,82,618
2017,Tourism Management,1707,6921,8628,375,990,1365,2082,7911,9993
2017,Transport and Conveying Technology,415,42,457,35,8,43,450,50,500
2017,Czech,11,16,27,2,17,19,13,33,46
2017,Turkish Studies,83,255,338,59,99,158,142,354,496
2017,Environmental Protection,879,1012,1891,439,313,752,1318,1325,2643
2017,Environmental Technology (including Recycling),5207,2725,7932,809,657,1466,6016,3382,9398
2017,Prehistory and Early History,473,522,995,42,56,98,515,578,1093
2017,Process Engineering,6149,3398,9547,1020,837,1857,7169,4235,11404
2017,Transport Engineering,3643,1141,4784,516,232,748,4159,1373,5532
2017,Transport Economics,1233,565,1798,209,143,352,1442,708,2150
2017,Surveying (Geodesy),3526,1425,4951,717,418,1135,4243,1843,6086
2017,Supply Technology,2883,444,3327,230,87,317,3113,531,3644
2017,Administrative Science/Public Administration,5873,8005,13878,192,267,459,6065,8272,14337
2017,Folklore,325,866,1191,23,89,112,348,955,1303
2017,Economics,13470,5964,19434,2328,2525,4853,15798,8489,24287
2017,Hydraulic Engineering,733,409,1142,144,124,268,877,533,1410
2017,Water Management,743,425,1168,263,188,451,1006,613,1619
2017,Viticulture and Oenology,721,393,1114,117,93,210,838,486,1324
2017,Handicrafts (technical)/Technology,139,253,392,3,22,25,142,275,417
2017,Handicrafts Education,22,77,99,,,,22,77,99
2017,Materials Technology,3909,1184,5093,991,499,1490,4900,1683,6583
2017,Western Slavic (general and n.e.c.),19,30,49,2,15,17,21,45,66
2017,Economic/Social Geography,283,307,590,10,19,29,293,326,619
2017,Economic/Social History,112,110,222,8,28,36,120,138,258
2017,Business Informatics,42248,9586,51834,4782,2877,7659,47030,12463,59493
2017,Business Engineering spec. in Engineering Sciences,47325,12212,59537,6319,3305,9624,53644,15517,69161
2017,Business Engineering specialising in Economics,24468,8052,32520,2938,1554,4492,27406,9606,37012
2017,Business Mathematics,4502,2986,7488,618,760,1378,5120,3746,8866
2017,Business and Economics Education,2554,4326,6880,101,275,376,2655,4601,7256
2017,Business Law,8957,11066,20023,644,1183,1827,9601,12249,21850
2017,Business and Economics,45652,34063,79715,4974,6352,11326,50626,40415,91041
2017,History of Science/History of Technology,20,9,29,3,2,5,23,11,34
2017,Dentistry,4365,8598,12963,1018,1170,2188,5383,9768,15151
2017,Customs and Tax Administration,2354,3081,5435,1,10,11,2355,3091,5446
2018,Waste Management,80,34,114,5,,5,85,34,119
2018,African Studies,395,711,1106,120,168,288,515,879,1394
2018,Agricultural Biology,256,259,515,184,137,321,440,396,836
2018,Agricultural Economics,870,609,1479,298,234,532,1168,843,2011
2018,Agricultural Science/Agriculture,7645,7143,14788,1139,1073,2212,8784,8216,17000
2018,Egyptology,252,357,609,61,71,132,313,428,741
2018,General Linguistics/Indo-European Studies,1348,3967,5315,303,1015,1318,1651,4982,6633
2018,General Literary Studies,786,2861,3647,133,449,582,919,3310,4229
2018,Ancient History,162,122,284,14,21,35,176,143,319
2018,American Studies,785,1651,2436,356,627,983,1141,2278,3419
2018,Applied Art,1269,2237,3506,203,332,535,1472,2569,4041
2018,Applied Linguistics,985,3943,4928,218,821,1039,1203,4764,5967
2018,Applied Systems Science,1727,441,2168,505,189,694,2232,630,2862
2018,English Studies,12157,29431,41588,1380,4052,5432,13537,33483,47020
2018,Anthropology (Human Biology),167,434,601,109,169,278,276,603,879
2018,Arabic/Arabic Studies,177,347,524,78,69,147,255,416,671
2018,Work Studies/Business Studies,715,1106,1821,25,75,100,740,1181,1921
2018,Occupational Guidance and Career Counselling,131,362,493,,3,3,131,365,496
2018,Labour Administration,278,744,1022,4,5,9,282,749,1031
2018,Archaeology,2500,2787,5287,191,283,474,2691,3070,5761
2018,Archaeometry (Archaeological Engineering),22,10,32,1,4,5,23,14,37
2018,Architecture,13901,16714,30615,3118,4495,7613,17019,21209,38228
2018,Archive and Documentation Science,133,194,327,11,40,51,144,234,378
2018,Archive Studies,118,128,246,1,5,6,119,133,252
2018,Asian Languages and Cultures/Asian Studies,526,1145,1671,260,508,768,786,1653,2439
2018,Astrophysics and Astronomy,204,65,269,157,114,271,361,179,540
2018,Ophthalmic Optics,220,475,695,27,31,58,247,506,753
2018,Immigrant Education,19,117,136,22,53,75,41,170,211
2018,Non-Europ. Lang. and Cult. in Oceania and America,82,167,249,27,81,108,109,248,357
2018,Foreign Affairs Administration,84,147,231,3,3,6,87,150,237
2018,Baltic Studies,5,2,7,,2,2,5,4,9
2018,Banking,473,270,743,7,4,11,480,274,754
2018,Civil Engineering/Structural Engineering,32286,13708,45994,7496,3050,10546,39782,16758,56540
2018,Mining/Mine Engineering,988,225,1213,534,152,686,1522,377,1899
2018,Occupation-specific Foreign Language Training,450,1147,1597,83,254,337,533,1401,1934
2018,"Vocational, Business and Economics Education",695,830,1525,37,52,89,732,882,1614
2018,Business Administration,110168,98112,208280,12008,14998,27006,122176,113110,235286
2018,Librarianship,17,47,64,,,,17,47,64
2018,Fine Arts/Graphics,1276,1609,2885,458,765,1223,1734,2374,4108
2018,Sculpting/Statuary Art,111,132,243,72,117,189,183,249,432
2018,Biochemistry,3094,4171,7265,560,870,1430,3654,5041,8695
2018,Bioinformatics,1347,835,2182,274,279,553,1621,1114,2735
2018,Biology,16655,29611,46266,2628,4414,7042,19283,34025,53308
2018,Biomedicine,560,1259,1819,293,382,675,853,1641,2494
2018,Biotechnology,4841,6048,10889,756,957,1713,5597,7005,12602
2018,Brewing Science/Beverage Technology,521,127,648,60,17,77,581,144,725
2018,Armed Forces Administration,246,275,521,3,1,4,249,276,525
2018,Byzantine Studies,7,18,25,18,9,27,25,27,52
2018,Caritas Science,52,76,128,13,14,27,65,90,155
2018,Chemistry,23838,15380,39218,3231,3338,6569,27069,18718,45787
2018,Chemical Engineering/Chemical Process Technology,5181,2558,7739,1068,802,1870,6249,3360,9609
2018,Computer Linguistics,713,575,1288,217,320,537,930,895,1825
2018,Computer and Communication Technology,2676,1664,4340,1010,454,1464,3686,2118,5804
2018,Danish,15,43,58,,1,1,15,44,59
2018,Performing Arts/Stagecraft/Directing,344,824,1168,144,306,450,488,1130,1618
2018,German as a Foreign or Second Language,561,2599,3160,479,1649,2128,1040,4248,5288
2018,Pastoral Care Studies,76,151,227,4,10,14,80,161,241
2018,Conducting,110,54,164,107,69,176,217,123,340
2018,Printing and Reproduction Technology,681,737,1418,99,93,192,780,830,1610
2018,Gemstone and Jewellery Design,8,51,59,8,39,47,16,90,106
2018,Electrical Power Engineering,1140,162,1302,464,115,579,1604,277,1881
2018,Electrical Engineering/Electronics,42779,5331,48110,16301,4060,20361,59080,9391,68471
2018,Energy Process Engineering,5032,1234,6266,1145,397,1542,6177,1631,7808
2018,Nutritional Science,550,2944,3494,82,313,395,632,3257,3889
2018,Adult Education and Extracurricular Youth Educat.,617,2082,2699,26,134,160,643,2216,2859
2018,Educational Science (Pedagogy),12582,43818,56400,794,3589,4383,13376,47407,60783
2018,Ethics,340,734,1074,22,70,92,362,804,1166
2018,Ethnology,1150,2932,4082,216,405,621,1366,3337,4703
2018,European Ethnology and Cultural Studies,865,2423,3288,219,491,710,1084,2914,3998
2018,European Economic Studies,1013,1422,2435,126,200,326,1139,1622,2761
2018,"Protestant Religious Pedagogy, Church Educat. Work",206,530,736,3,4,7,209,534,743
2018,"Protestant Theology, Protes. Religious Education",4629,6829,11458,368,294,662,4997,7123,12120
2018,Facility Management,1885,1360,3245,63,90,153,1948,1450,3398
2018,Automotive Technology,10222,717,10939,2461,304,2765,12683,1021,13704
2018,Precision Engineering,461,54,515,83,9,92,544,63,607
2018,Manufacturing Technology/Production Engineering,4889,825,5714,1400,303,1703,6289,1128,7417
2018,Film and Television Studies,1411,1082,2493,186,220,406,1597,1302,2899
2018,Financial Administration,792,1134,1926,5,6,11,797,1140,1937
2018,Finno-Ugrian Studies,42,107,149,6,12,18,48,119,167
2018,"Forest Science, Forestry",3785,2010,5795,518,397,915,4303,2407,6710
2018,French,1005,4526,5531,199,587,786,1204,5113,6317
2018,Horticulture,1230,887,2117,86,102,188,1316,989,2305
2018,Geography,10226,9805,20031,609,627,1236,10835,10432,21267
2018,Geology/Palaeontology,247,178,425,137,88,225,384,266,650
2018,Geoecology,545,723,1268,58,58,116,603,781,1384
2018,Geophysics,1001,874,1875,106,79,185,1107,953,2060
2018,Geosciences general,5780,3979,9759,943,665,1608,6723,4644,11367
2018,German Studies/German,14593,50459,65052,1559,5990,7549,16152,56449,72601
2018,Singing,283,461,744,309,389,698,592,850,1442
2018,History,18343,13904,32247,1326,1529,2855,19669,15433,35102
2018,Health Education,792,3417,4209,22,102,124,814,3519,4333
2018,Health Technology,5167,4777,9944,1787,1287,3074,6954,6064,13018
2018,Health Science/Health Management,11824,27271,39095,939,2066,3005,12763,29337,42100
2018,Glass Technology/Ceramics,137,46,183,13,9,22,150,55,205
2018,Graphic Design/Communication Design,6425,10791,17216,1018,2009,3027,7443,12800,20243
2018,Greek,203,187,390,52,57,109,255,244,499
2018,Primary School Education/Primary Level Education,1149,6616,7765,33,153,186,1182,6769,7951
2018,Domestic and Nutritional Sciences,1396,6267,7663,133,383,516,1529,6650,8179
2018,Domestic Science,47,150,197,1,2,3,48,152,200
2018,Wood and Fibre Technology,771,129,900,42,18,60,813,147,960
2018,Timber Construction,643,132,775,31,10,41,674,142,816
2018,Wood Science,285,85,370,19,15,34,304,100,404
2018,Metallurgy and Foundry,511,173,684,297,127,424,808,300,1108
2018,Indology,64,102,166,19,23,42,83,125,208
2018,Industrial Design/Product Design,1770,1638,3408,312,406,718,2082,2044,4126
2018,Computer Science,81809,16716,98525,16792,5883,22675,98601,22599,121200
2018,Inf./Library Scien. (not at univ. of app.adm.sci.),657,2169,2826,45,166,211,702,2335,3037
2018,Computational Engineer./Technical Computer Science,9253,1323,10576,2646,674,3320,11899,1997,13896
2018,Interior Architecture,409,2751,3160,80,357,437,489,3108,3597
2018,Internal Administration,2257,4263,6520,27,69,96,2284,4332,6616
2018,Instrumental Music,1155,1170,2325,2030,2488,4518,3185,3658,6843
2018,Interdisc. Studies (specialising in Engineering),10883,3896,14779,2391,988,3379,13274,4884,18158
2018,Interdisc. Studies (special. in Natural Sciences),2853,2917,5770,975,786,1761,3828,3703,7531
2018,"Interdisc. St. (spec. in Law, Econ. and Soc. Sci.)",5994,7650,13644,973,1519,2492,6967,9169,16136
2018,Interdisc. Studies (spec. in Humanities),5210,13183,18393,1084,2586,3670,6294,15769,22063
2018,"Interdisc. Studies (special. in Art, Art Theory)",234,497,731,75,131,206,309,628,937
2018,International Business Studies/Management,18113,22544,40657,5857,6540,12397,23970,29084,53054
2018,Iranian Studies,80,109,189,32,39,71,112,148,260
2018,Islamic Studies/Islamic theology,132,248,380,59,102,161,191,350,541
2018,Islamic Studies,607,1185,1792,181,266,447,788,1451,2239
2018,Italian,229,673,902,87,348,435,316,1021,1337
2018,Japanese Studies,1422,1742,3164,145,327,472,1567,2069,3636
2018,Jazz and Popular Music,918,314,1232,176,86,262,1094,400,1494
2018,Judaic Studies/Hebrew,220,329,549,44,57,101,264,386,650
2018,Law Enforcement,85,99,184,,,,85,99,184
2018,Cartography,185,93,278,72,63,135,257,156,413
2018,"Catholic Religious Pedagogy, Church Educat. Work",118,272,390,3,14,17,121,286,407
2018,"Catholic Theology, Catholic Religious Education",3166,3888,7054,483,176,659,3649,4064,7713
2018,Caucasian Studies,1,,1,,2,2,1,2,3
2018,Nucl.Techn./Nucl.Process Techn.(cl.w.SF211 s.2020),3,,3,,2,2,3,2,5
2018,Church Music,268,146,414,39,55,94,307,201,508
2018,Classical Philology,185,216,401,30,45,75,215,261,476
2018,"Communication Technology, Information Engineering",4702,702,5404,2111,575,2686,6813,1277,8090
2018,Communication Science/Journalism,5331,11949,17280,413,1224,1637,5744,13173,18917
2018,Composition,140,33,173,137,125,262,277,158,435
2018,Arts Education,964,4294,5258,107,386,493,1071,4680,5751
2018,"Art History, Art Theory",2127,8131,10258,255,1131,1386,2382,9262,11644
2018,Plastics Technology,990,211,1201,172,43,215,1162,254,1416
2018,Land Management Engineering/Landscape Design,2071,2564,4635,126,291,417,2197,2855,5052
2018,Landscape Ecology/Biogeography (ex. SF385 s. 2012),479,746,1225,19,34,53,498,780,1278
2018,Latin,1110,1438,2548,49,56,105,1159,1494,2653
2018,Latin America Studies,136,314,450,46,100,146,182,414,596
2018,Food Chemistry,719,1584,2303,46,131,177,765,1715,2480
2018,Food Technology,1630,2250,3880,146,231,377,1776,2481,4257
2018,Area of study: Humanities,899,5159,6058,27,209,236,926,5368,6294
2018,Area of study: Social Studies,219,226,445,7,11,18,226,237,463
2018,Area of study: Natural Sciences/General Studies,801,3859,4660,18,94,112,819,3953,4772
2018,Area of study: Technology,753,435,1188,18,17,35,771,452,1223
2018,Aeronautical and Aerospace Engineering,5461,749,6210,944,218,1162,6405,967,7372
2018,Painting,169,210,379,105,154,259,274,364,638
2018,Mine Surveying,17,10,27,1,2,3,18,12,30
2018,Mechanical Engineering,77940,9979,87919,18387,3139,21526,96327,13118,109445
2018,Materials Engineering,843,304,1147,262,166,428,1105,470,1575
2018,Math.Statistics/Prob.Calc. (class.w. SF312 s.2020),1200,965,2165,204,215,419,1404,1180,2584
2018,Mathematics,28111,26448,54559,3253,2551,5804,31364,28999,60363
2018,Mechatronics,12561,1255,13816,4681,648,5329,17242,1903,19145
2018,Media Informatics,11167,5192,16359,1111,808,1919,12278,6000,18278
2018,Media Technology,4541,3053,7594,304,241,545,4845,3294,8139
2018,Media Economics/Media Management,3527,6076,9603,287,632,919,3814,6708,10522
2018,Media Science,3761,7957,11718,354,892,1246,4115,8849,12964
2018,Medicine (General Medicine),31025,52565,83590,5454,7071,12525,36479,59636,96115
2018,Medical Informatics,1322,1011,2333,379,395,774,1701,1406,3107
2018,Metals Technology,681,137,818,7,7,14,688,144,832
2018,Meteorology,753,567,1320,80,81,161,833,648,1481
2018,Microelectronics,116,7,123,152,52,204,268,59,327
2018,Microsystems Technology,1079,191,1270,989,268,1257,2068,459,2527
2018,Dairy Farming,47,34,81,8,17,25,55,51,106
2018,Mineralogy,34,10,44,54,15,69,88,25,113
2018,Medieval and Modern History,480,387,867,46,47,93,526,434,960
2018,Music Education,3259,4089,7348,266,562,828,3525,4651,8176
2018,Musicology/History of Music,2125,2217,4342,313,529,842,2438,2746,5184
2018,Nature Conservation,246,489,735,76,167,243,322,656,978
2018,Nautical Science/Maritime Studies,618,182,800,156,22,178,774,204,978
2018,New Media,944,898,1842,225,232,457,1169,1130,2299
2018,Modern Greek,20,27,47,19,56,75,39,83,122
2018,Non-medical Healthcare Professions/Therapies,2225,8309,10534,241,599,840,2466,8908,11374
2018,Low German,2,2,4,,,,2,2,4
2018,Dutch,107,245,352,17,29,46,124,274,398
2018,"Nordic/Scand. St. (Nord. Phil., ind. lang. n.e.c.)",358,924,1282,35,99,134,393,1023,1416
2018,Optoelectronics,402,124,526,83,29,112,485,153,638
2018,Orchestral Music,462,441,903,509,619,1128,971,1060,2031
2018,"Oriental Studies, Ancient Oriental Studies",556,831,1387,144,161,305,700,992,1692
2018,Eastern and South Eastern Europe Studies,170,280,450,65,142,207,235,422,657
2018,Oceanography,8,7,15,9,6,15,17,13,30
2018,Early Childhood Education,347,2889,3236,13,165,178,360,3054,3414
2018,Plant Production,418,341,759,41,30,71,459,371,830
2018,Nursing Science/Nursing Management,2621,8552,11173,115,455,570,2736,9007,11743
2018,Pharmacy,4286,9416,13702,766,1518,2284,5052,10934,15986
2018,Philosophy,9531,7466,16997,1270,1202,2472,10801,8668,19469
2018,Physics,31275,12723,43998,4810,2268,7078,36085,14991,51076
2018,Engineering Physics/Mechanical Process Engineering,2328,599,2927,835,237,1072,3163,836,3999
2018,Political Science,15914,11790,27704,2135,2755,4890,18049,14545,32594
2018,Police/Protection of the Constitution,14643,7227,21870,123,56,179,14766,7283,22049
2018,Polish,26,44,70,6,29,35,32,73,105
2018,Portuguese,35,71,106,14,28,42,49,99,148
2018,Psychology,20297,58822,79119,1428,4643,6071,21725,63465,85190
2018,Spatial Planning,2243,2417,4660,445,643,1088,2688,3060,5748
2018,Administration of Justice,627,1777,2404,,1,1,627,1778,2405
2018,Law,47500,59054,106554,3666,6623,10289,51166,65677,116843
2018,Renewable Energy,1839,517,2356,486,160,646,2325,677,3002
2018,Religious Studies,644,1087,1731,117,163,280,761,1250,2011
2018,Restoration Studies,149,647,796,14,66,80,163,713,876
2018,Rhythmics,2,24,26,,5,5,2,29,31
2018,"Romance Studies (Rom. Phil., indiv. lang. n.e.c.)",602,2094,2696,249,818,1067,851,2912,3763
2018,Russian,244,526,770,47,244,291,291,770,1061
2018,General Studies (including School Garden),90,406,496,3,17,20,93,423,516
2018,Drama Studies,236,246,482,47,35,82,283,281,564
2018,Naval Architecture/Ship Technology,711,130,841,201,46,247,912,176,1088
2018,School Pedagogy,223,449,672,35,47,82,258,496,754
2018,Sinology/Korean Studies,951,1732,2683,166,577,743,1117,2309,3426
2018,Slavic Studies (Slavic Philology),392,774,1166,101,455,556,493,1229,1722
2018,Special Needs Education,2411,12500,14911,42,273,315,2453,12773,15226
2018,Other subjects,1013,1171,2184,1167,1172,2339,2180,2343,4523
2018,Other regional studies,140,229,369,39,103,142,179,332,511
2018,Sorabistics,7,26,33,1,4,5,8,30,38
2018,Social Work,13421,42258,55679,805,2648,3453,14226,44906,59132
2018,Social Studies,1702,1610,3312,65,119,184,1767,1729,3496
2018,Social Pedagogy,1581,7166,8747,44,261,305,1625,7427,9052
2018,Social Security Administration,532,1338,1870,64,55,119,596,1393,1989
2018,Applied Social Science,5426,18127,23553,315,1007,1322,5741,19134,24875
2018,Social Sciences,8179,11435,19614,905,1540,2445,9084,12975,22059
2018,Sociology,6507,10953,17460,654,1455,2109,7161,12408,19569
2018,Spanish,1237,3617,4854,229,694,923,1466,4311,5777
2018,Sports Management/Sports Economics,3793,1395,5188,268,89,357,4061,1484,5545
2018,Sports Education/Sports Psychology,5575,3901,9476,195,112,307,5770,4013,9783
2018,Sports Science,10866,6768,17634,664,380,1044,11530,7148,18678
2018,Steel Construction,51,6,57,7,,7,58,6,64
2018,"South Slavic (Bulgar., Serbo-Croat., Slovene etc.)",2,10,12,2,2,4,4,12,16
2018,Dance Education,23,137,160,71,145,216,94,282,376
2018,Technical Cybernetics,356,76,432,48,10,58,404,86,490
2018,Technomathematics,1498,501,1999,142,78,220,1640,579,2219
2018,Textile Design,356,2281,2637,68,442,510,424,2723,3147
2018,Textile and Clothing Technology/Industry,394,2184,2578,214,320,534,608,2504,3112
2018,Theatre Studies,763,2100,2863,96,311,407,859,2411,3270
2018,Veterinary Medicine,1085,6173,7258,185,524,709,1270,6697,7967
2018,Animal Production,78,243,321,25,18,43,103,261,364
2018,Sound Engineering,423,54,477,49,10,59,472,64,536
2018,Tourism Management,1840,7101,8941,469,969,1438,2309,8070,10379
2018,Transport and Conveying Technology,367,52,419,48,6,54,415,58,473
2018,Czech,11,13,24,5,16,21,16,29,45
2018,Turkish Studies,74,277,351,58,114,172,132,391,523
2018,Environmental Protection,868,1020,1888,507,349,856,1375,1369,2744
2018,Environmental Technology (including Recycling),4638,2667,7305,764,648,1412,5402,3315,8717
2018,Prehistory and Early History,436,509,945,39,59,98,475,568,1043
2018,Process Engineering,5754,3341,9095,1105,897,2002,6859,4238,11097
2018,Transport Engineering,3521,1087,4608,607,242,849,4128,1329,5457
2018,Transport Economics,1201,644,1845,250,155,405,1451,799,2250
2018,Surveying (Geodesy),3347,1382,4729,777,425,1202,4124,1807,5931
2018,Supply Technology,2715,465,3180,234,77,311,2949,542,3491
2018,Administrative Science/Public Administration,6209,8736,14945,200,279,479,6409,9015,15424
2018,Folklore,304,880,1184,21,85,106,325,965,1290
2018,Economics,12830,5696,18526,2295,2532,4827,15125,8228,23353
2018,Hydraulic Engineering,681,401,1082,170,135,305,851,536,1387
2018,Water Management,684,400,1084,289,196,485,973,596,1569
2018,Viticulture and Oenology,650,342,992,100,80,180,750,422,1172
2018,Handicrafts (technical)/Technology,133,264,397,3,29,32,136,293,429
2018,Handicrafts Education,24,67,91,,3,3,24,70,94
2018,Materials Technology,3630,1137,4767,1109,501,1610,4739,1638,6377
2018,Western Slavic (general and n.e.c.),16,29,45,4,10,14,20,39,59
2018,Economic/Social Geography,278,295,573,16,16,32,294,311,605
2018,Economic/Social History,149,113,262,10,45,55,159,158,317
2018,Business Informatics,43722,10316,54038,5102,2964,8066,48824,13280,62104
2018,Business Engineering spec. in Engineering Sciences,47361,12461,59822,7314,3555,10869,54675,16016,70691
2018,Business Engineering specialising in Economics,23085,7764,30849,2704,1529,4233,25789,9293,35082
2018,Business Mathematics,4240,2730,6970,614,821,1435,4854,3551,8405
2018,Business and Economics Education,2605,4270,6875,101,291,392,2706,4561,7267
2018,Business Law,8906,11391,20297,657,1250,1907,9563,12641,22204
2018,Business and Economics,44765,33506,78271,5169,6383,11552,49934,39889,89823
2018,History of Science/History of Technology,20,12,32,3,1,4,23,13,36
2018,Dentistry,4325,8681,13006,1051,1194,2245,5376,9875,15251
2018,Customs and Tax Administration,2629,3535,6164,4,17,21,2633,3552,6185
2019,Waste Management,66,30,96,4,,4,70,30,100
2019,African Studies,389,711,1100,130,179,309,519,890,1409
2019,Agricultural Biology,330,352,682,224,174,398,554,526,1080
2019,Agricultural Economics,829,545,1374,338,260,598,1167,805,1972
2019,Agricultural Science/Agriculture,7451,6926,14377,1145,1047,2192,8596,7973,16569
2019,Egyptology,293,397,690,64,73,137,357,470,827
2019,General Linguistics/Indo-European Studies,1374,3838,5212,280,1013,1293,1654,4851,6505
2019,General Literary Studies,774,2883,3657,145,467,612,919,3350,4269
2019,Ancient History,154,105,259,8,22,30,162,127,289
2019,American Studies,712,1540,2252,353,666,1019,1065,2206,3271
2019,Applied Art,1260,2295,3555,187,348,535,1447,2643,4090
2019,Applied Linguistics,966,3793,4759,220,838,1058,1186,4631,5817
2019,Applied Systems Science,1708,433,2141,562,214,776,2270,647,2917
2019,English Studies,12234,29635,41869,1437,4174,5611,13671,33809,47480
2019,Anthropology (Human Biology),129,323,452,81,155,236,210,478,688
2019,Arabic/Arabic Studies,159,329,488,87,78,165,246,407,653
2019,Work Studies/Business Studies,745,1188,1933,33,74,107,778,1262,2040
2019,Occupational Guidance and Career Counselling,149,358,507,1,3,4,150,361,511
2019,Labour Administration,301,722,1023,5,5,10,306,727,1033
2019,Archaeology,2512,2863,5375,194,292,486,2706,3155,5861
2019,Archaeometry (Archaeological Engineering),17,7,24,1,4,5,18,11,29
2019,Architecture,13832,16950,30782,3110,4446,7556,16942,21396,38338
2019,Archive and Documentation Science,156,227,383,10,29,39,166,256,422
2019,Archive Studies,140,169,309,1,2,3,141,171,312
2019,Asian Languages and Cultures/Asian Studies,467,1035,1502,254,510,764,721,1545,2266
2019,Astrophysics and Astronomy,201,74,275,193,122,315,394,196,590
2019,Ophthalmic Optics,230,502,732,25,45,70,255,547,802
2019,Immigrant Education,18,132,150,28,54,82,46,186,232
2019,Non-Europ. Lang. and Cult. in Oceania and America,75,158,233,27,79,106,102,237,339
2019,Foreign Affairs Administration,92,152,244,1,5,6,93,157,250
2019,Baltic Studies,4,,4,1,1,2,5,1,6
2019,Banking,506,287,793,6,4,10,512,291,803
2019,Civil Engineering/Structural Engineering,31397,13608,45005,7995,3103,11098,39392,16711,56103
2019,Mining/Mine Engineering,949,248,1197,677,193,870,1626,441,2067
2019,Occupation-specific Foreign Language Training,430,1077,1507,133,249,382,563,1326,1889
2019,"Vocational, Business and Economics Education",711,797,1508,37,49,86,748,846,1594
2019,Business Administration,110772,98417,209189,12457,15305,27762,123229,113722,236951
2019,Librarianship,22,45,67,,,,22,45,67
2019,Fine Arts/Graphics,1262,1694,2956,457,778,1235,1719,2472,4191
2019,Sculpting/Statuary Art,94,126,220,74,112,186,168,238,406
2019,Biochemistry,3018,4245,7263,579,957,1536,3597,5202,8799
2019,Bioinformatics,1302,869,2171,304,306,610,1606,1175,2781
2019,Biology,16386,29867,46253,2714,4726,7440,19100,34593,53693
2019,Biomedicine,586,1382,1968,336,440,776,922,1822,2744
2019,Biotechnology,4751,6046,10797,797,1116,1913,5548,7162,12710
2019,Brewing Science/Beverage Technology,484,117,601,61,24,85,545,141,686
2019,Armed Forces Administration,248,286,534,2,2,4,250,288,538
2019,Byzantine Studies,8,18,26,12,12,24,20,30,50
2019,Caritas Science,42,65,107,10,19,29,52,84,136
2019,Chemistry,23156,15285,38441,3347,3455,6802,26503,18740,45243
2019,Chemical Engineering/Chemical Process Technology,4909,2461,7370,1013,796,1809,5922,3257,9179
2019,Computer Linguistics,661,568,1229,220,345,565,881,913,1794
2019,Computer and Communication Technology,2985,1950,4935,978,484,1462,3963,2434,6397
2019,Danish,11,36,47,1,,1,12,36,48
2019,Performing Arts/Stagecraft/Directing,330,833,1163,157,332,489,487,1165,1652
2019,German as a Foreign or Second Language,520,2486,3006,423,1591,2014,943,4077,5020
2019,Pastoral Care Studies,89,160,249,3,7,10,92,167,259
2019,Conducting,113,63,176,107,70,177,220,133,353
2019,Printing and Reproduction Technology,584,729,1313,93,94,187,677,823,1500
2019,Gemstone and Jewellery Design,7,36,43,8,39,47,15,75,90
2019,Electrical Power Engineering,1497,268,1765,531,167,698,2028,435,2463
2019,Electrical Engineering/Electronics,41001,5206,46207,16987,4404,21391,57988,9610,67598
2019,Energy Process Engineering,4230,1061,5291,1057,334,1391,5287,1395,6682
2019,Nutritional Science,708,3695,4403,112,478,590,820,4173,4993
2019,Adult Education and Extracurricular Youth Educat.,573,2024,2597,29,140,169,602,2164,2766
2019,Educational Science (Pedagogy),12546,43751,56297,831,3599,4430,13377,47350,60727
2019,Ethics,344,789,1133,30,73,103,374,862,1236
2019,Ethnology,1075,2728,3803,215,431,646,1290,3159,4449
2019,European Ethnology and Cultural Studies,789,2228,3017,210,478,688,999,2706,3705
2019,European Economic Studies,879,1255,2134,143,205,348,1022,1460,2482
2019,"Protestant Religious Pedagogy, Church Educat. Work",211,505,716,3,3,6,214,508,722
2019,"Protestant Theology, Protes. Religious Education",4456,6573,11029,371,293,664,4827,6866,11693
2019,Facility Management,1967,1370,3337,79,97,176,2046,1467,3513
2019,Automotive Technology,9662,705,10367,2560,326,2886,12222,1031,13253
2019,Precision Engineering,452,43,495,85,13,98,537,56,593
2019,Manufacturing Technology/Production Engineering,4458,741,5199,1403,292,1695,5861,1033,6894
2019,Film and Television Studies,1363,1073,2436,212,235,447,1575,1308,2883
2019,Financial Administration,870,1261,2131,4,2,6,874,1263,2137
2019,Finno-Ugrian Studies,50,95,145,3,15,18,53,110,163
2019,"Forest Science, Forestry",3766,2105,5871,495,379,874,4261,2484,6745
2019,French,935,4100,5035,192,578,770,1127,4678,5805
2019,Horticulture,1196,791,1987,88,89,177,1284,880,2164
2019,Geography,10289,10169,20458,634,641,1275,10923,10810,21733
2019,Geology/Palaeontology,219,151,370,111,75,186,330,226,556
2019,Geoecology,521,727,1248,66,58,124,587,785,1372
2019,Geophysics,1048,930,1978,128,98,226,1176,1028,2204
2019,Geosciences general,5498,4059,9557,999,724,1723,6497,4783,11280
2019,German Studies/German,14329,50349,64678,1584,5832,7416,15913,56181,72094
2019,Singing,284,470,754,294,390,684,578,860,1438
2019,History,18188,13921,32109,1361,1548,2909,19549,15469,35018
2019,Health Education,958,3917,4875,32,128,160,990,4045,5035
2019,Health Technology,4996,4925,9921,2025,1461,3486,7021,6386,13407
2019,Health Science/Health Management,12263,27931,40194,1067,2225,3292,13330,30156,43486
2019,Glass Technology/Ceramics,119,41,160,15,10,25,134,51,185
2019,Graphic Design/Communication Design,6572,11599,18171,1125,2285,3410,7697,13884,21581
2019,Greek,194,172,366,49,62,111,243,234,477
2019,Primary School Education/Primary Level Education,1357,7400,8757,29,178,207,1386,7578,8964
2019,Domestic and Nutritional Sciences,1373,5995,7368,147,418,565,1520,6413,7933
2019,Domestic Science,40,141,181,1,1,2,41,142,183
2019,Wood and Fibre Technology,716,150,866,43,16,59,759,166,925
2019,Timber Construction,587,117,704,27,11,38,614,128,742
2019,Wood Science,217,59,276,23,16,39,240,75,315
2019,Metallurgy and Foundry,453,145,598,287,112,399,740,257,997
2019,Indology,63,88,151,19,26,45,82,114,196
2019,Industrial Design/Product Design,1783,1662,3445,302,424,726,2085,2086,4171
2019,Computer Science,84504,17766,102270,18687,6580,25267,103191,24346,127537
2019,Inf./Library Scien. (not at univ. of app.adm.sci.),660,2116,2776,54,165,219,714,2281,2995
2019,Computational Engineer./Technical Computer Science,9577,1581,11158,3057,856,3913,12634,2437,15071
2019,Interior Architecture,384,2724,3108,83,346,429,467,3070,3537
2019,Internal Administration,2375,4597,6972,34,74,108,2409,4671,7080
2019,Instrumental Music,1145,1146,2291,2025,2472,4497,3170,3618,6788
2019,Interdisc. Studies (specialising in Engineering),10907,4012,14919,2673,1052,3725,13580,5064,18644
2019,Interdisc. Studies (special. in Natural Sciences),3067,3209,6276,1047,894,1941,4114,4103,8217
2019,"Interdisc. St. (spec. in Law, Econ. and Soc. Sci.)",5898,7668,13566,1011,1542,2553,6909,9210,16119
2019,Interdisc. Studies (spec. in Humanities),5345,13184,18529,1054,2674,3728,6399,15858,22257
2019,"Interdisc. Studies (special. in Art, Art Theory)",272,585,857,93,137,230,365,722,1087
2019,International Business Studies/Management,17239,21210,38449,6003,6703,12706,23242,27913,51155
2019,Iranian Studies,87,89,176,40,40,80,127,129,256
2019,Islamic Studies/Islamic theology,297,521,818,104,135,239,401,656,1057
2019,Islamic Studies,401,829,1230,148,185,333,549,1014,1563
2019,Italian,216,611,827,91,346,437,307,957,1264
2019,Japanese Studies,1399,1748,3147,173,350,523,1572,2098,3670
2019,Jazz and Popular Music,932,343,1275,167,75,242,1099,418,1517
2019,Judaic Studies/Hebrew,205,305,510,43,66,109,248,371,619
2019,Law Enforcement,108,105,213,,,,108,105,213
2019,Cartography,180,90,270,75,51,126,255,141,396
2019,"Catholic Religious Pedagogy, Church Educat. Work",119,288,407,20,23,43,139,311,450
2019,"Catholic Theology, Catholic Religious Education",3025,3947,6972,469,167,636,3494,4114,7608
2019,Caucasian Studies,1,1,2,,3,3,1,4,5
2019,Nucl.Techn./Nucl.Process Techn.(cl.w.SF211 s.2020),2,,2,,2,2,2,2,4
2019,Church Music,291,140,431,41,53,94,332,193,525
2019,Classical Philology,173,213,386,34,38,72,207,251,458
2019,"Communication Technology, Information Engineering",4391,655,5046,2103,637,2740,6494,1292,7786
2019,Communication Science/Journalism,4957,11641,16598,390,1224,1614,5347,12865,18212
2019,Composition,134,43,177,159,125,284,293,168,461
2019,Arts Education,982,4329,5311,110,403,513,1092,4732,5824
2019,"Art History, Art Theory",2172,7767,9939,238,1111,1349,2410,8878,11288
2019,Plastics Technology,847,166,1013,116,34,150,963,200,1163
2019,Land Management Engineering/Landscape Design,2023,2662,4685,122,267,389,2145,2929,5074
2019,Landscape Ecology/Biogeography (ex. SF385 s. 2012),480,755,1235,17,31,48,497,786,1283
2019,Latin,991,1288,2279,52,54,106,1043,1342,2385
2019,Latin America Studies,127,293,420,48,104,152,175,397,572
2019,Food Chemistry,671,1521,2192,52,130,182,723,1651,2374
2019,Food Technology,1549,2121,3670,151,238,389,1700,2359,4059
2019,Area of study: Humanities,899,5319,6218,37,195,232,936,5514,6450
2019,Area of study: Social Studies,207,211,418,2,8,10,209,219,428
2019,Area of study: Natural Sciences/General Studies,914,4376,5290,22,96,118,936,4472,5408
2019,Area of study: Technology,719,388,1107,12,15,27,731,403,1134
2019,Aeronautical and Aerospace Engineering,5351,775,6126,983,231,1214,6334,1006,7340
2019,Painting,172,196,368,101,154,255,273,350,623
2019,Mine Surveying,18,11,29,4,5,9,22,16,38
2019,Mechanical Engineering,72793,9560,82353,18632,3192,21824,91425,12752,104177
2019,Materials Engineering,1190,443,1633,512,279,791,1702,722,2424
2019,Math.Statistics/Prob.Calc. (class.w. SF312 s.2020),1432,1047,2479,316,281,597,1748,1328,3076
2019,Mathematics,27653,26000,53653,3285,2588,5873,30938,28588,59526
2019,Mechatronics,12024,1250,13274,5397,776,6173,17421,2026,19447
2019,Media Informatics,10883,5284,16167,1208,842,2050,12091,6126,18217
2019,Media Technology,4561,3045,7606,361,278,639,4922,3323,8245
2019,Media Economics/Media Management,3986,6647,10633,326,641,967,4312,7288,11600
2019,Media Science,3638,7975,11613,376,911,1287,4014,8886,12900
2019,Medicine (General Medicine),31441,54340,85781,5595,7360,12955,37036,61700,98736
2019,Medical Informatics,1443,1092,2535,427,419,846,1870,1511,3381
2019,Metals Technology,676,126,802,11,6,17,687,132,819
2019,Meteorology,736,612,1348,89,87,176,825,699,1524
2019,Microelectronics,98,14,112,143,49,192,241,63,304
2019,Microsystems Technology,1036,195,1231,955,280,1235,1991,475,2466
2019,Dairy Farming,44,23,67,8,15,23,52,38,90
2019,Mineralogy,29,7,36,48,14,62,77,21,98
2019,Medieval and Modern History,475,379,854,45,40,85,520,419,939
2019,Music Education,3267,4103,7370,294,566,860,3561,4669,8230
2019,Musicology/History of Music,2057,2152,4209,306,531,837,2363,2683,5046
2019,Nature Conservation,258,512,770,84,196,280,342,708,1050
2019,Nautical Science/Maritime Studies,598,176,774,176,28,204,774,204,978
2019,New Media,1058,1119,2177,209,262,471,1267,1381,2648
2019,Modern Greek,14,20,34,19,56,75,33,76,109
2019,Non-medical Healthcare Professions/Therapies,2275,8845,11120,222,633,855,2497,9478,11975
2019,Low German,1,2,3,,,,1,2,3
2019,Dutch,100,228,328,18,21,39,118,249,367
2019,"Nordic/Scand. St. (Nord. Phil., ind. lang. n.e.c.)",332,781,1113,32,93,125,364,874,1238
2019,Optoelectronics,352,114,466,96,32,128,448,146,594
2019,Orchestral Music,410,396,806,474,646,1120,884,1042,1926
2019,"Oriental Studies, Ancient Oriental Studies",539,717,1256,142,149,291,681,866,1547
2019,Eastern and South Eastern Europe Studies,156,243,399,55,138,193,211,381,592
2019,Oceanography,4,5,9,9,4,13,13,9,22
2019,Early Childhood Education,378,3243,3621,19,226,245,397,3469,3866
2019,Plant Production,392,324,716,47,34,81,439,358,797
2019,Nursing Science/Nursing Management,2705,8888,11593,128,486,614,2833,9374,12207
2019,Pharmacy,4306,9390,13696,833,1594,2427,5139,10984,16123
2019,Philosophy,9538,7721,17259,1302,1244,2546,10840,8965,19805
2019,Physics,31174,13335,44509,5014,2427,7441,36188,15762,51950
2019,Engineering Physics/Mechanical Process Engineering,2481,712,3193,866,250,1116,3347,962,4309
2019,Political Science,15697,11962,27659,2155,2880,5035,17852,14842,32694
2019,Police/Protection of the Constitution,15651,8109,23760,137,69,206,15788,8178,23966
2019,Polish,25,43,68,5,22,27,30,65,95
2019,Portuguese,36,54,90,12,23,35,48,77,125
2019,Psychology,21572,62646,84218,1573,5173,6746,23145,67819,90964
2019,Spatial Planning,2222,2402,4624,490,688,1178,2712,3090,5802
2019,Administration of Justice,659,1942,2601,,2,2,659,1944,2603
2019,Law,47304,59748,107052,3659,6406,10065,50963,66154,117117
2019,Renewable Energy,1845,595,2440,755,202,957,2600,797,3397
2019,Religious Studies,605,1047,1652,126,162,288,731,1209,1940
2019,Restoration Studies,158,600,758,14,57,71,172,657,829
2019,Rhythmics,1,13,14,,4,4,1,17,18
2019,"Romance Studies (Rom. Phil., indiv. lang. n.e.c.)",568,1935,2503,232,786,1018,800,2721,3521
2019,Russian,216,465,681,40,207,247,256,672,928
2019,General Studies (including School Garden),103,472,575,5,18,23,108,490,598
2019,Drama Studies,226,245,471,49,41,90,275,286,561
2019,Naval Architecture/Ship Technology,582,101,683,201,40,241,783,141,924
2019,School Pedagogy,182,368,550,42,52,94,224,420,644
2019,Sinology/Korean Studies,940,1789,2729,169,593,762,1109,2382,3491
2019,Slavic Studies (Slavic Philology),358,700,1058,95,405,500,453,1105,1558
2019,Special Needs Education,2607,13185,15792,52,298,350,2659,13483,16142
2019,Other subjects,996,1234,2230,1125,1211,2336,2121,2445,4566
2019,Other regional studies,138,210,348,38,127,165,176,337,513
2019,Sorabistics,9,25,34,2,7,9,11,32,43
2019,Social Work,14473,46120,60593,934,2986,3920,15407,49106,64513
2019,Social Studies,1743,1748,3491,69,121,190,1812,1869,3681
2019,Social Pedagogy,1744,7778,9522,53,291,344,1797,8069,9866
2019,Social Security Administration,623,1503,2126,64,61,125,687,1564,2251
2019,Applied Social Science,5549,18889,24438,367,1106,1473,5916,19995,25911
2019,Social Sciences,8182,11518,19700,948,1651,2599,9130,13169,22299
2019,Sociology,6297,10837,17134,657,1427,2084,6954,12264,19218
2019,Spanish,1157,3344,4501,219,673,892,1376,4017,5393
2019,Sports Management/Sports Economics,3893,1342,5235,308,92,400,4201,1434,5635
2019,Sports Education/Sports Psychology,5832,4015,9847,178,115,293,6010,4130,10140
2019,Sports Science,11057,6875,17932,712,423,1135,11769,7298,19067
2019,Steel Construction,56,8,64,8,,8,64,8,72
2019,"South Slavic (Bulgar., Serbo-Croat., Slovene etc.)",3,5,8,2,2,4,5,7,12
2019,Dance Education,28,136,164,83,153,236,111,289,400
2019,Technical Cybernetics,351,80,431,43,8,51,394,88,482
2019,Technomathematics,1536,509,2045,184,94,278,1720,603,2323
2019,Textile Design,387,2116,2503,78,462,540,465,2578,3043
2019,Textile and Clothing Technology/Industry,375,2060,2435,216,298,514,591,2358,2949
2019,Theatre Studies,722,2088,2810,99,308,407,821,2396,3217
2019,Veterinary Medicine,1086,6183,7269,170,545,715,1256,6728,7984
2019,Animal Production,80,242,322,22,20,42,102,262,364
2019,Sound Engineering,404,60,464,57,12,69,461,72,533
2019,Tourism Management,1948,7475,9423,425,945,1370,2373,8420,10793
2019,Transport and Conveying Technology,347,46,393,31,8,39,378,54,432
2019,Czech,7,16,23,2,21,23,9,37,46
2019,Turkish Studies,68,270,338,49,109,158,117,379,496
2019,Environmental Protection,871,1029,1900,558,368,926,1429,1397,2826
2019,Environmental Technology (including Recycling),4320,2644,6964,787,649,1436,5107,3293,8400
2019,Prehistory and Early History,474,545,1019,41,59,100,515,604,1119
2019,Process Engineering,5360,3186,8546,1130,924,2054,6490,4110,10600
2019,Transport Engineering,3357,1049,4406,719,264,983,4076,1313,5389
2019,Transport Economics,1122,491,1613,271,150,421,1393,641,2034
2019,Surveying (Geodesy),3099,1328,4427,799,440,1239,3898,1768,5666
2019,Supply Technology,2562,425,2987,204,69,273,2766,494,3260
2019,Administrative Science/Public Administration,6564,9503,16067,186,277,463,6750,9780,16530
2019,Folklore,274,825,1099,25,83,108,299,908,1207
2019,Economics,12119,5520,17639,2340,2491,4831,14459,8011,22470
2019,Hydraulic Engineering,669,402,1071,190,147,337,859,549,1408
2019,Water Management,595,373,968,295,191,486,890,564,1454
2019,Viticulture and Oenology,713,397,1110,122,91,213,835,488,1323
2019,Handicrafts (technical)/Technology,138,273,411,5,50,55,143,323,466
2019,Handicrafts Education,27,73,100,,2,2,27,75,102
2019,Materials Technology,2858,1014,3872,1048,448,1496,3906,1462,5368
2019,Western Slavic (general and n.e.c.),15,23,38,6,5,11,21,28,49
2019,Economic/Social Geography,269,258,527,13,13,26,282,271,553
2019,Economic/Social History,125,109,234,14,56,70,139,165,304
2019,Business Informatics,45010,10648,55658,5379,3109,8488,50389,13757,64146
2019,Business Engineering spec. in Engineering Sciences,45694,12256,57950,8002,3731,11733,53696,15987,69683
2019,Business Engineering specialising in Economics,22516,7454,29970,3003,1528,4531,25519,8982,34501
2019,Business Mathematics,3982,2559,6541,611,812,1423,4593,3371,7964
2019,Business and Economics Education,2563,4108,6671,90,259,349,2653,4367,7020
2019,Business Law,8628,11522,20150,695,1258,1953,9323,12780,22103
2019,Business and Economics,42981,32272,75253,5295,6370,11665,48276,38642,86918
2019,History of Science/History of Technology,22,8,30,2,1,3,24,9,33
2019,Dentistry,4323,8837,13160,1044,1192,2236,5367,10029,15396
2019,Customs and Tax Administration,2813,3744,6557,5,23,28,2818,3767,6585
2020,Waste Management,53,26,79,2,,2,55,26,81
2020,African Studies,357,631,988,141,190,331,498,821,1319
2020,Agricultural Biology,373,398,771,282,234,516,655,632,1287
2020,Agricultural Economics,792,539,1331,359,240,599,1151,779,1930
2020,Agricultural Science/Agriculture,7432,6966,14398,1143,1047,2190,8575,8013,16588
2020,Egyptology,219,307,526,51,67,118,270,374,644
2020,General Linguistics/Indo-European Studies,1340,3879,5219,293,948,1241,1633,4827,6460
2020,General Literary Studies,773,3090,3863,136,454,590,909,3544,4453
2020,Ancient History,143,90,233,9,16,25,152,106,258
2020,American Studies,672,1564,2236,393,623,1016,1065,2187,3252
2020,Applied Art,1370,2539,3909,149,335,484,1519,2874,4393
2020,Applied Linguistics,974,3773,4747,209,749,958,1183,4522,5705
2020,Applied Systems Science,1759,472,2231,606,227,833,2365,699,3064
2020,English Studies,12664,30718,43382,1408,3976,5384,14072,34694,48766
2020,Anthropology (Human Biology),109,335,444,75,151,226,184,486,670
2020,Arabic/Arabic Studies,163,344,507,94,79,173,257,423,680
2020,Work Studies/Business Studies,861,1295,2156,40,84,124,901,1379,2280
2020,Occupational Guidance and Career Counselling,204,523,727,2,7,9,206,530,736
2020,Labour Administration,368,916,1284,5,7,12,373,923,1296
2020,Archaeology,2388,2709,5097,188,277,465,2576,2986,5562
2020,Archaeometry (Archaeological Engineering),21,6,27,3,3,6,24,9,33
2020,Architecture,14397,18405,32802,2985,4432,7417,17382,22837,40219
2020,Archive and Documentation Science,139,241,380,15,42,57,154,283,437
2020,Archive Studies,150,197,347,2,5,7,152,202,354
2020,Asian Languages and Cultures/Asian Studies,442,1034,1476,229,494,723,671,1528,2199
2020,Astrophysics and Astronomy,191,83,274,194,127,321,385,210,595
2020,Ophthalmic Optics,225,508,733,25,49,74,250,557,807
2020,Immigrant Education,17,125,142,27,60,87,44,185,229
2020,Non-Europ. Lang. and Cult. in Oceania and America,78,152,230,30,75,105,108,227,335
2020,Foreign Affairs Administration,102,158,260,1,5,6,103,163,266
2020,Baltic Studies,3,2,5,1,2,3,4,4,8
2020,Banking,517,316,833,8,5,13,525,321,846
2020,Civil Engineering/Structural Engineering,32124,14087,46211,8284,3116,11400,40408,17203,57611
2020,Mining/Mine Engineering,845,231,1076,735,223,958,1580,454,2034
2020,Occupation-specific Foreign Language Training,438,1038,1476,56,178,234,494,1216,1710
2020,"Vocational, Business and Economics Education",717,967,1684,41,58,99,758,1025,1783
2020,Business Administration,114157,100627,214784,12999,15217,28216,127156,115844,243000
2020,Librarianship,18,41,59,,1,1,18,42,60
2020,Fine Arts/Graphics,1194,1620,2814,456,784,1240,1650,2404,4054
2020,Sculpting/Statuary Art,105,142,247,81,119,200,186,261,447
2020,Biochemistry,3087,4310,7397,616,1015,1631,3703,5325,9028
2020,Bioinformatics,1257,861,2118,339,357,696,1596,1218,2814
2020,Biology,16435,30956,47391,2725,4841,7566,19160,35797,54957
2020,Biomedicine,615,1516,2131,344,481,825,959,1997,2956
2020,Biotechnology,4641,6149,10790,867,1233,2100,5508,7382,12890
2020,Brewing Science/Beverage Technology,513,130,643,59,20,79,572,150,722
2020,Armed Forces Administration,248,298,546,9,5,14,257,303,560
2020,Byzantine Studies,6,22,28,14,12,26,20,34,54
2020,Caritas Science,25,79,104,10,14,24,35,93,128
2020,Chemistry,22075,15010,37085,3267,3474,6741,25342,18484,43826
2020,Chemical Engineering/Chemical Process Technology,4704,2424,7128,1007,829,1836,5711,3253,8964
2020,Computer Linguistics,609,561,1170,228,392,620,837,953,1790
2020,Computer and Communication Technology,3222,2061,5283,918,510,1428,4140,2571,6711
2020,Danish,13,53,66,1,1,2,14,54,68
2020,Performing Arts/Stagecraft/Directing,380,856,1236,142,329,471,522,1185,1707
2020,German as a Foreign or Second Language,449,2390,2839,351,1404,1755,800,3794,4594
2020,Pastoral Care Studies,134,182,316,11,11,22,145,193,338
2020,Conducting,103,51,154,105,67,172,208,118,326
2020,Printing and Reproduction Technology,568,753,1321,110,99,209,678,852,1530
2020,Gemstone and Jewellery Design,6,30,36,10,30,40,16,60,76
2020,Electrical Power Engineering,1367,249,1616,537,169,706,1904,418,2322
2020,Electrical Engineering/Electronics,39500,4909,44409,17398,4448,21846,56898,9357,66255
2020,Energy Process Engineering,3989,1013,5002,1092,354,1446,5081,1367,6448
2020,Nutritional Science,903,4608,5511,125,597,722,1028,5205,6233
2020,Adult Education and Extracurricular Youth Educat.,601,2096,2697,31,147,178,632,2243,2875
2020,Educational Science (Pedagogy),12636,44881,57517,793,3543,4336,13429,48424,61853
2020,Ethics,342,764,1106,29,76,105,371,840,1211
2020,Ethnology,1013,2585,3598,244,415,659,1257,3000,4257
2020,European Ethnology and Cultural Studies,785,2295,3080,213,455,668,998,2750,3748
2020,European Economic Studies,907,1278,2185,153,216,369,1060,1494,2554
2020,"Protestant Religious Pedagogy, Church Educat. Work",209,490,699,2,6,8,211,496,707
2020,"Protestant Theology, Protes. Religious Education",4121,6092,10213,330,260,590,4451,6352,10803
2020,Facility Management,2046,1400,3446,100,97,197,2146,1497,3643
2020,Automotive Technology,9292,666,9958,2556,305,2861,11848,971,12819
2020,Precision Engineering,487,47,534,85,15,100,572,62,634
2020,Manufacturing Technology/Production Engineering,4115,704,4819,1341,261,1602,5456,965,6421
2020,Film and Television Studies,1369,1095,2464,229,246,475,1598,1341,2939
2020,Financial Administration,922,1295,2217,5,3,8,927,1298,2225
2020,Finno-Ugrian Studies,38,80,118,4,12,16,42,92,134
2020,"Forest Science, Forestry",3625,2039,5664,493,356,849,4118,2395,6513
2020,French,931,3944,4875,166,512,678,1097,4456,5553
2020,Horticulture,1193,875,2068,98,81,179,1291,956,2247
2020,Geography,10164,10409,20573,604,632,1236,10768,11041,21809
2020,Geology/Palaeontology,185,141,326,91,68,159,276,209,485
2020,Geoecology,596,797,1393,55,53,108,651,850,1501
2020,Geophysics,942,836,1778,107,104,211,1049,940,1989
2020,Geosciences general,5188,3840,9028,1034,686,1720,6222,4526,10748
2020,German Studies/German,13788,49996,63784,1104,4368,5472,14892,54364,69256
2020,Singing,282,484,766,290,416,706,572,900,1472
2020,History,17997,13832,31829,1268,1426,2694,19265,15258,34523
2020,Health Education,1082,4416,5498,36,162,198,1118,4578,5696
2020,Health Technology,4995,4980,9975,2131,1582,3713,7126,6562,13688
2020,Health Science/Health Management,9576,26867,36443,982,2398,3380,10558,29265,39823
2020,Glass Technology/Ceramics,112,42,154,14,13,27,126,55,181
2020,Graphic Design/Communication Design,6886,12783,19669,1178,2376,3554,8064,15159,23223
2020,Greek,168,161,329,45,50,95,213,211,424
2020,Primary School Education/Primary Level Education,1511,8099,9610,44,202,246,1555,8301,9856
2020,Domestic and Nutritional Sciences,1319,5846,7165,170,436,606,1489,6282,7771
2020,Domestic Science,43,138,181,1,1,2,44,139,183
2020,Wood and Fibre Technology,719,153,872,34,9,43,753,162,915
2020,Timber Construction,590,132,722,25,8,33,615,140,755
2020,Wood Science,173,36,209,28,21,49,201,57,258
2020,Metallurgy and Foundry,409,113,522,297,116,413,706,229,935
2020,Indology,42,80,122,19,20,39,61,100,161
2020,Industrial Design/Product Design,1840,1731,3571,296,402,698,2136,2133,4269
2020,Computer Science,87429,18338,105767,20601,7397,27998,108030,25735,133765
2020,Inf./Library Scien. (not at univ. of app.adm.sci.),589,1955,2544,42,133,175,631,2088,2719
2020,Computational Engineer./Technical Computer Science,9706,1550,11256,3235,907,4142,12941,2457,15398
2020,Interior Architecture,383,2919,3302,86,362,448,469,3281,3750
2020,Internal Administration,2506,4894,7400,17,54,71,2523,4948,7471
2020,Instrumental Music,1314,1254,2568,2099,2549,4648,3413,3803,7216
2020,Interdisc. Studies (specialising in Engineering),11017,4080,15097,2837,1085,3922,13854,5165,19019
2020,Interdisc. Studies (special. in Natural Sciences),3335,3531,6866,1123,1033,2156,4458,4564,9022
2020,"Interdisc. St. (spec. in Law, Econ. and Soc. Sci.)",6360,8362,14722,1043,1558,2601,7403,9920,17323
2020,Interdisc. Studies (spec. in Humanities),5214,13021,18235,953,2435,3388,6167,15456,21623
2020,"Interdisc. Studies (special. in Art, Art Theory)",277,606,883,113,161,274,390,767,1157
2020,International Business Studies/Management,16855,21059,37914,6195,6850,13045,23050,27909,50959
2020,Iranian Studies,69,64,133,37,41,78,106,105,211
2020,Islamic Studies/Islamic theology,317,506,823,102,118,220,419,624,1043
2020,Islamic Studies,370,807,1177,153,180,333,523,987,1510
2020,Italian,212,574,786,75,296,371,287,870,1157
2020,Japanese Studies,1418,1794,3212,144,280,424,1562,2074,3636
2020,Jazz and Popular Music,960,358,1318,172,63,235,1132,421,1553
2020,Judaic Studies/Hebrew,185,296,481,42,61,103,227,357,584
2020,Law Enforcement,94,114,208,,,,94,114,208
2020,Cartography,172,72,244,82,63,145,254,135,389
2020,"Catholic Religious Pedagogy, Church Educat. Work",119,274,393,61,96,157,180,370,550
2020,"Catholic Theology, Catholic Religious Education",2767,3710,6477,429,165,594,3196,3875,7071
2020,Caucasian Studies,,,,,2,2,,2,2
2020,Church Music,292,126,418,45,45,90,337,171,508
2020,Classical Philology,172,194,366,35,41,76,207,235,442
2020,"Communication Technology, Information Engineering",4442,639,5081,2177,693,2870,6619,1332,7951
2020,Communication Science/Journalism,4914,11895,16809,389,1152,1541,5303,13047,18350
2020,Composition,129,49,178,159,114,273,288,163,451
2020,Arts Education,989,4577,5566,108,427,535,1097,5004,6101
2020,"Art History, Art Theory",2082,7891,9973,231,1069,1300,2313,8960,11273
2020,Plastics Technology,714,143,857,92,34,126,806,177,983
2020,Land Management Engineering/Landscape Design,2046,2836,4882,118,282,400,2164,3118,5282
2020,Landscape Ecology/Biogeography (ex. SF385 s. 2012),493,787,1280,16,32,48,509,819,1328
2020,Latin,863,1176,2039,36,48,84,899,1224,2123
2020,Latin America Studies,130,296,426,49,107,156,179,403,582
2020,Food Chemistry,663,1503,2166,54,141,195,717,1644,2361
2020,Food Technology,1579,2149,3728,139,256,395,1718,2405,4123
2020,Area of study: Humanities,1151,6750,7901,35,170,205,1186,6920,8106
2020,Area of study: Social Studies,210,231,441,4,4,8,214,235,449
2020,Area of study: Natural Sciences/General Studies,770,3494,4264,17,78,95,787,3572,4359
2020,Area of study: Technology,659,336,995,15,14,29,674,350,1024
2020,Aeronautical and Aerospace Engineering,5486,836,6322,1072,266,1338,6558,1102,7660
2020,Painting,173,212,385,97,149,246,270,361,631
2020,Mine Surveying,19,12,31,7,4,11,26,16,42
2020,Mechanical Engineering,69710,9325,79035,18185,3036,21221,87895,12361,100256
2020,Materials Engineering,1145,428,1573,483,278,761,1628,706,2334
2020,Mathematics,26853,25834,52687,3350,2556,5906,30203,28390,58593
2020,Mechatronics,11642,1191,12833,5830,830,6660,17472,2021,19493
2020,Media Informatics,10892,5426,16318,1204,888,2092,12096,6314,18410
2020,Media Technology,4686,3359,8045,407,279,686,5093,3638,8731
2020,Media Economics/Media Management,4307,7521,11828,340,777,1117,4647,8298,12945
2020,Media Science,3743,8406,12149,372,912,1284,4115,9318,13433
2020,Medicine (General Medicine),31959,56912,88871,5492,7349,12841,37451,64261,101712
2020,Medical Informatics,1499,1147,2646,495,497,992,1994,1644,3638
2020,Metals Technology,636,116,752,4,4,8,640,120,760
2020,Meteorology,670,499,1169,74,68,142,744,567,1311
2020,Microelectronics,47,7,54,165,76,241,212,83,295
2020,Microsystems Technology,1038,203,1241,954,302,1256,1992,505,2497
2020,Dairy Farming,42,27,69,8,21,29,50,48,98
2020,Mineralogy,109,49,158,48,15,63,157,64,221
2020,Medieval and Modern History,435,347,782,36,39,75,471,386,857
2020,Music Education,3302,4256,7558,321,595,916,3623,4851,8474
2020,Musicology/History of Music,2004,2165,4169,281,512,793,2285,2677,4962
2020,Nature Conservation,387,714,1101,153,269,422,540,983,1523
2020,Nautical Science/Maritime Studies,644,169,813,222,33,255,866,202,1068
2020,New Media,1099,1232,2331,234,282,516,1333,1514,2847
2020,Modern Greek,12,20,32,18,49,67,30,69,99
2020,Non-medical Healthcare Professions/Therapies,2405,9875,12280,186,620,806,2591,10495,13086
2020,Low German,2,2,4,,,,2,2,4
2020,Dutch,108,223,331,10,18,28,118,241,359
2020,"Nordic/Scand. St. (Nord. Phil., ind. lang. n.e.c.)",354,802,1156,27,79,106,381,881,1262
2020,Optoelectronics,321,119,440,103,36,139,424,155,579
2020,Orchestral Music,344,373,717,512,675,1187,856,1048,1904
2020,"Oriental Studies, Ancient Oriental Studies",442,595,1037,140,140,280,582,735,1317
2020,Eastern and South Eastern Europe Studies,156,245,401,60,119,179,216,364,580
2020,Oceanography,8,7,15,9,5,14,17,12,29
2020,Early Childhood Education,395,3305,3700,21,246,267,416,3551,3967
2020,Plant Production,367,298,665,44,28,72,411,326,737
2020,Nursing Science/Nursing Management,2895,9300,12195,148,539,687,3043,9839,12882
2020,Pharmacy,4308,9479,13787,871,1649,2520,5179,11128,16307
2020,Philosophy,9400,7695,17095,1196,1051,2247,10596,8746,19342
2020,Physics,30208,12409,42617,5070,2460,7530,35278,14869,50147
2020,Engineering Physics/Mechanical Process Engineering,2239,643,2882,902,237,1139,3141,880,4021
2020,Political Science,15627,12463,28090,1967,2545,4512,17594,15008,32602
2020,Police/Protection of the Constitution,15456,8535,23991,121,70,191,15577,8605,24182
2020,Polish,21,39,60,5,14,19,26,53,79
2020,Portuguese,38,53,91,8,24,32,46,77,123
2020,Psychology,23677,69510,93187,1773,5815,7588,25450,75325,100775
2020,Spatial Planning,2326,2453,4779,483,721,1204,2809,3174,5983
2020,Administration of Justice,680,2160,2840,,1,1,680,2161,2841
2020,Law,47725,62112,109837,3308,6140,9448,51033,68252,119285
2020,Renewable Energy,2052,632,2684,851,232,1083,2903,864,3767
2020,Religious Studies,581,958,1539,149,169,318,730,1127,1857
2020,Restoration Studies,178,603,781,10,58,68,188,661,849
2020,Rhythmics,1,14,15,,3,3,1,17,18
2020,"Romance Studies (Rom. Phil., indiv. lang. n.e.c.)",541,1712,2253,211,598,809,752,2310,3062
2020,Russian,203,423,626,39,204,243,242,627,869
2020,General Studies (including School Garden),124,544,668,5,21,26,129,565,694
2020,Drama Studies,231,269,500,50,48,98,281,317,598
2020,Naval Architecture/Ship Technology,582,97,679,212,37,249,794,134,928
2020,School Pedagogy,173,346,519,42,63,105,215,409,624
2020,Sinology/Korean Studies,947,1914,2861,175,569,744,1122,2483,3605
2020,Slavic Studies (Slavic Philology),343,650,993,94,376,470,437,1026,1463
2020,Special Needs Education,2820,14291,17111,48,313,361,2868,14604,17472
2020,Other subjects,1056,1365,2421,594,581,1175,1650,1946,3596
2020,Other regional studies,158,238,396,35,108,143,193,346,539
2020,Sorabistics,4,19,23,3,5,8,7,24,31
2020,Social Work,15916,52320,68236,1045,3316,4361,16961,55636,72597
2020,Social Studies,1758,1879,3637,74,121,195,1832,2000,3832
2020,Social Pedagogy,1951,8598,10549,49,321,370,2000,8919,10919
2020,Social Security Administration,697,1649,2346,65,73,138,762,1722,2484
2020,Applied Social Science,5683,19130,24813,371,1074,1445,6054,20204,26258
2020,Social Sciences,8390,11890,20280,948,1615,2563,9338,13505,22843
2020,Sociology,6429,11423,17852,702,1508,2210,7131,12931,20062
2020,Spanish,1111,3240,4351,212,636,848,1323,3876,5199
2020,Sports Management/Sports Economics,6793,3076,9869,501,179,680,7294,3255,10549
2020,Sports Education/Sports Psychology,6264,4412,10676,146,96,242,6410,4508,10918
2020,Sports Science,11477,7351,18828,736,462,1198,12213,7813,20026
2020,Steel Construction,66,10,76,4,,4,70,10,80
2020,Statistics,1608,990,2598,817,478,1295,2425,1468,3893
2020,"South Slavic (Bulgar., Serbo-Croat., Slovene etc.)",3,6,9,2,1,3,5,7,12
2020,Dance Education,25,124,149,92,173,265,117,297,414
2020,Technical Cybernetics,348,82,430,43,10,53,391,92,483
2020,Technomathematics,1656,484,2140,234,103,337,1890,587,2477
2020,Textile Design,476,2126,2602,70,403,473,546,2529,3075
2020,Textile and Clothing Technology/Industry,439,1963,2402,212,275,487,651,2238,2889
2020,Theatre Studies,729,2103,2832,90,294,384,819,2397,3216
2020,Veterinary Medicine,1035,6199,7234,149,548,697,1184,6747,7931
2020,Animal Production,75,233,308,27,22,49,102,255,357
2020,Sound Engineering,388,58,446,63,15,78,451,73,524
2020,Tourism Management,1986,7362,9348,475,926,1401,2461,8288,10749
2020,Transport and Conveying Technology,316,44,360,31,11,42,347,55,402
2020,Czech,4,19,23,2,25,27,6,44,50
2020,Turkish Studies,64,247,311,43,99,142,107,346,453
2020,Environmental Protection,886,1028,1914,552,376,928,1438,1404,2842
2020,Environmental Technology (including Recycling),4199,2626,6825,776,651,1427,4975,3277,8252
2020,Prehistory and Early History,455,518,973,41,49,90,496,567,1063
2020,Process Engineering,5052,3044,8096,1183,942,2125,6235,3986,10221
2020,Transport Engineering,3304,987,4291,891,280,1171,4195,1267,5462
2020,Transport Economics,1115,459,1574,288,182,470,1403,641,2044
2020,Surveying (Geodesy),3008,1254,4262,758,400,1158,3766,1654,5420
2020,Supply Technology,2464,427,2891,263,87,350,2727,514,3241
2020,Administrative Science/Public Administration,6906,10228,17134,210,294,504,7116,10522,17638
2020,Folklore,275,821,1096,23,100,123,298,921,1219
2020,Economics,11991,5489,17480,2329,2403,4732,14320,7892,22212
2020,Hydraulic Engineering,648,432,1080,181,167,348,829,599,1428
2020,Water Management,529,330,859,319,199,518,848,529,1377
2020,Viticulture and Oenology,713,410,1123,125,96,221,838,506,1344
2020,Handicrafts (technical)/Technology,144,257,401,3,27,30,147,284,431
2020,Handicrafts Education,30,74,104,,,,30,74,104
2020,Materials Technology,2726,948,3674,1159,494,1653,3885,1442,5327
2020,Western Slavic (general and n.e.c.),10,17,27,4,6,10,14,23,37
2020,Economic/Social Geography,278,256,534,15,15,30,293,271,564
2020,Economic/Social History,110,93,203,16,45,61,126,138,264
2020,Business Informatics,46532,11179,57711,5717,3294,9011,52249,14473,66722
2020,Business Engineering spec. in Engineering Sciences,45320,12303,57623,8588,3909,12497,53908,16212,70120
2020,Business Engineering specialising in Economics,21961,7334,29295,3073,1462,4535,25034,8796,33830
2020,Business Mathematics,3557,2260,5817,598,783,1381,4155,3043,7198
2020,Business and Economics Education,2585,4215,6800,81,265,346,2666,4480,7146
2020,Business Law,8643,12105,20748,668,1311,1979,9311,13416,22727
2020,Business and Economics,44022,33765,77787,5371,6318,11689,49393,40083,89476
2020,History of Science/History of Technology,26,8,34,1,,1,27,8,35
2020,Dentistry,4284,8980,13264,1062,1249,2311,5346,10229,15575
2020,Customs and Tax Administration,2956,3948,6904,8,30,38,2964,3978,6942
2021,Waste Management,55,27,82,2,1,3,57,28,85
2021,African Studies,370,637,1007,160,183,343,530,820,1350
2021,Agricultural Biology,364,375,739,283,244,527,647,619,1266
2021,Agricultural Economics,758,503,1261,400,271,671,1158,774,1932
2021,Agricultural Science/Agriculture,7060,6411,13471,1137,1074,2211,8197,7485,15682
2021,Egyptology,218,329,547,45,57,102,263,386,649
2021,General Linguistics/Indo-European Studies,1252,3526,4778,308,966,1274,1560,4492,6052
2021,General Literary Studies,791,3063,3854,157,533,690,948,3596,4544
2021,Ancient History,135,97,232,13,19,32,148,116,264
2021,American Studies,648,1480,2128,404,659,1063,1052,2139,3191
2021,Applied Art,1315,2569,3884,134,352,486,1449,2921,4370
2021,Applied Linguistics,924,3388,4312,233,821,1054,1157,4209,5366
2021,Applied Systems Science,1726,447,2173,677,243,920,2403,690,3093
2021,English Studies,12565,30343,42908,1431,4219,5650,13996,34562,48558
2021,Anthropology (Human Biology),100,322,422,70,159,229,170,481,651
2021,Arabic/Arabic Studies,155,293,448,90,91,181,245,384,629
2021,Work Studies/Business Studies,873,1270,2143,45,72,117,918,1342,2260
2021,Occupational Guidance and Career Counselling,170,459,629,3,8,11,173,467,640
2021,Labour Administration,301,678,979,7,7,14,308,685,993
2021,Archaeology,2461,2754,5215,196,299,495,2657,3053,5710
2021,Archaeometry (Archaeological Engineering),16,8,24,3,2,5,19,10,29
2021,Architecture,14811,18951,33762,3174,4634,7808,17985,23585,41570
2021,Archive and Documentation Science,150,259,409,15,49,64,165,308,473
2021,Archive Studies,178,237,415,5,8,13,183,245,428
2021,Asian Languages and Cultures/Asian Studies,415,966,1381,234,473,707,649,1439,2088
2021,Astrophysics and Astronomy,202,78,280,229,141,370,431,219,650
2021,Ophthalmic Optics,227,522,749,29,55,84,256,577,833
2021,Immigrant Education,15,118,133,31,61,92,46,179,225
2021,Non-Europ. Lang. and Cult. in Oceania and America,67,120,187,25,66,91,92,186,278
2021,Foreign Affairs Administration,105,152,257,,,,105,152,257
2021,Baltic Studies,4,3,7,,3,3,4,6,10
2021,Banking,475,340,815,5,8,13,480,348,828
2021,Civil Engineering/Structural Engineering,32311,14028,46339,8380,3211,11591,40691,17239,57930
2021,Mining/Mine Engineering,748,231,979,777,232,1009,1525,463,1988
2021,Occupation-specific Foreign Language Training,394,848,1242,78,177,255,472,1025,1497
2021,"Vocational, Business and Economics Education",730,1121,1851,53,74,127,783,1195,1978
2021,Business Administration,112816,97537,210353,14403,16110,30513,127219,113647,240866
2021,Librarianship,17,38,55,,1,1,17,39,56
2021,Fine Arts/Graphics,1157,1642,2799,470,840,1310,1627,2482,4109
2021,Sculpting/Statuary Art,97,143,240,85,103,188,182,246,428
2021,Biochemistry,3040,4323,7363,653,1100,1753,3693,5423,9116
2021,Bioinformatics,1231,866,2097,361,415,776,1592,1281,2873
2021,Biology,16462,31108,47570,2817,5217,8034,19279,36325,55604
2021,Biomedicine,596,1603,2199,371,539,910,967,2142,3109
2021,Biotechnology,4564,6218,10782,1043,1527,2570,5607,7745,13352
2021,Brewing Science/Beverage Technology,468,126,594,65,18,83,533,144,677
2021,Armed Forces Administration,240,290,530,10,5,15,250,295,545
2021,Byzantine Studies,7,21,28,14,9,23,21,30,51
2021,Caritas Science,25,67,92,8,10,18,33,77,110
2021,Chemistry,20683,14119,34802,3304,3581,6885,23987,17700,41687
2021,Chemical Engineering/Chemical Process Technology,4583,2318,6901,1023,847,1870,5606,3165,8771
2021,Computer Linguistics,572,537,1109,292,450,742,864,987,1851
2021,Computer and Communication Technology,3364,2114,5478,868,544,1412,4232,2658,6890
2021,Danish,17,69,86,,1,1,17,70,87
2021,Performing Arts/Stagecraft/Directing,385,890,1275,122,319,441,507,1209,1716
2021,German as a Foreign or Second Language,406,2149,2555,350,1317,1667,756,3466,4222
2021,Pastoral Care Studies,114,149,263,15,18,33,129,167,296
2021,Conducting,102,55,157,115,72,187,217,127,344
2021,Printing and Reproduction Technology,555,719,1274,113,98,211,668,817,1485
2021,Gemstone and Jewellery Design,7,26,33,13,37,50,20,63,83
2021,Electrical Power Engineering,1523,236,1759,542,167,709,2065,403,2468
2021,Electrical Engineering/Electronics,37364,4645,42009,17773,4622,22395,55137,9267,64404
2021,Energy Process Engineering,3568,883,4451,1052,338,1390,4620,1221,5841
2021,Nutritional Science,1034,5038,6072,147,704,851,1181,5742,6923
2021,Adult Education and Extracurricular Youth Educat.,579,1966,2545,31,132,163,610,2098,2708
2021,Educational Science (Pedagogy),12525,44596,57121,830,3640,4470,13355,48236,61591
2021,Ethics,378,868,1246,40,85,125,418,953,1371
2021,Ethnology,923,2277,3200,263,406,669,1186,2683,3869
2021,European Ethnology and Cultural Studies,762,2157,2919,228,486,714,990,2643,3633
2021,European Economic Studies,852,1179,2031,178,214,392,1030,1393,2423
2021,"Protestant Religious Pedagogy, Church Educat. Work",226,458,684,2,6,8,228,464,692
2021,"Protestant Theology, Protes. Religious Education",3675,5492,9167,357,240,597,4032,5732,9764
2021,Facility Management,2180,1386,3566,88,87,175,2268,1473,3741
2021,Automotive Technology,8885,648,9533,2532,290,2822,11417,938,12355
2021,Precision Engineering,493,45,538,94,13,107,587,58,645
2021,Manufacturing Technology/Production Engineering,3903,675,4578,1265,272,1537,5168,947,6115
2021,Film and Television Studies,1319,1085,2404,238,270,508,1557,1355,2912
2021,Financial Administration,976,1399,2375,2,2,4,978,1401,2379
2021,Finno-Ugrian Studies,35,73,108,6,9,15,41,82,123
2021,"Forest Science, Forestry",3680,2078,5758,473,327,800,4153,2405,6558
2021,French,857,3578,4435,162,531,693,1019,4109,5128
2021,Horticulture,1171,902,2073,94,82,176,1265,984,2249
2021,Geography,9810,10296,20106,606,656,1262,10416,10952,21368
2021,Geology/Palaeontology,179,135,314,80,54,134,259,189,448
2021,Geoecology,547,691,1238,69,58,127,616,749,1365
2021,Geophysics,897,787,1684,128,116,244,1025,903,1928
2021,Geosciences general,4764,3590,8354,1034,723,1757,5798,4313,10111
2021,German Studies/German,13082,48279,61361,1175,4616,5791,14257,52895,67152
2021,Singing,270,454,724,280,399,679,550,853,1403
2021,History,17466,13335,30801,1291,1383,2674,18757,14718,33475
2021,Health Education,1266,4953,6219,46,185,231,1312,5138,6450
2021,Health Technology,4873,4796,9669,2312,1800,4112,7185,6596,13781
2021,Health Science/Health Management,9533,27195,36728,944,2531,3475,10477,29726,40203
2021,Glass Technology/Ceramics,90,32,122,13,10,23,103,42,145
2021,Graphic Design/Communication Design,7446,14216,21662,1326,2785,4111,8772,17001,25773
2021,Greek,158,140,298,44,44,88,202,184,386
2021,Primary School Education/Primary Level Education,1547,8128,9675,36,192,228,1583,8320,9903
2021,Domestic and Nutritional Sciences,1251,5535,6786,179,431,610,1430,5966,7396
2021,Domestic Science,37,123,160,1,1,2,38,124,162
2021,Wood and Fibre Technology,707,132,839,33,8,41,740,140,880
2021,Timber Construction,577,115,692,19,7,26,596,122,718
2021,Wood Science,149,27,176,32,18,50,181,45,226
2021,Metallurgy and Foundry,351,89,440,287,112,399,638,201,839
2021,Indology,43,73,116,16,26,42,59,99,158
2021,Industrial Design/Product Design,1818,1757,3575,298,423,721,2116,2180,4296
2021,Computer Science,89084,17840,106924,23094,8374,31468,112178,26214,138392
2021,Inf./Library Scien. (not at univ. of app.adm.sci.),584,1947,2531,37,124,161,621,2071,2692
2021,Computational Engineer./Technical Computer Science,9969,1571,11540,3544,1043,4587,13513,2614,16127
2021,Interior Architecture,439,3342,3781,101,481,582,540,3823,4363
2021,Internal Administration,2532,5086,7618,16,54,70,2548,5140,7688
2021,Instrumental Music,1307,1179,2486,1998,2437,4435,3305,3616,6921
2021,Interdisc. Studies (specialising in Engineering),11289,4091,15380,3272,1323,4595,14561,5414,19975
2021,Interdisc. Studies (special. in Natural Sciences),3332,3582,6914,1310,1262,2572,4642,4844,9486
2021,"Interdisc. St. (spec. in Law, Econ. and Soc. Sci.)",6502,8324,14826,1188,1766,2954,7690,10090,17780
2021,Interdisc. Studies (spec. in Humanities),5031,12100,17131,1091,2575,3666,6122,14675,20797
2021,"Interdisc. Studies (special. in Art, Art Theory)",268,601,869,140,214,354,408,815,1223
2021,International Business Studies/Management,16182,19955,36137,6937,7545,14482,23119,27500,50619
2021,Iranian Studies,63,58,121,36,40,76,99,98,197
2021,Islamic Studies/Islamic theology,394,555,949,121,131,252,515,686,1201
2021,Islamic Studies,278,652,930,130,153,283,408,805,1213
2021,Italian,209,555,764,71,295,366,280,850,1130
2021,Japanese Studies,1370,1712,3082,156,280,436,1526,1992,3518
2021,Jazz and Popular Music,914,326,1240,169,74,243,1083,400,1483
2021,Judaic Studies/Hebrew,183,274,457,43,66,109,226,340,566
2021,Law Enforcement,84,113,197,,,,84,113,197
2021,Cartography,162,76,238,77,65,142,239,141,380
2021,"Catholic Religious Pedagogy, Church Educat. Work",112,266,378,109,99,208,221,365,586
2021,"Catholic Theology, Catholic Religious Education",2483,3370,5853,398,148,546,2881,3518,6399
2021,Caucasian Studies,2,1,3,,1,1,2,2,4
2021,Church Music,280,129,409,47,51,98,327,180,507
2021,Classical Philology,142,180,322,34,36,70,176,216,392
2021,"Communication Technology, Information Engineering",3941,612,4553,2166,728,2894,6107,1340,7447
2021,Communication Science/Journalism,4781,11859,16640,401,1199,1600,5182,13058,18240
2021,Composition,148,45,193,154,131,285,302,176,478
2021,Arts Education,1042,4758,5800,110,435,545,1152,5193,6345
2021,"Art History, Art Theory",1991,7445,9436,212,1071,1283,2203,8516,10719
2021,Plastics Technology,593,130,723,71,29,100,664,159,823
2021,Land Management Engineering/Landscape Design,2032,2855,4887,115,272,387,2147,3127,5274
2021,Landscape Ecology/Biogeography (ex. SF385 s. 2012),477,766,1243,21,32,53,498,798,1296
2021,Latin,772,1055,1827,36,49,85,808,1104,1912
2021,Latin America Studies,109,247,356,50,103,153,159,350,509
2021,Food Chemistry,632,1380,2012,56,146,202,688,1526,2214
2021,Food Technology,1447,1945,3392,150,273,423,1597,2218,3815
2021,Area of study: Humanities,1231,7071,8302,63,188,251,1294,7259,8553
2021,Area of study: Social Studies,195,237,432,4,2,6,199,239,438
2021,Area of study: Natural Sciences/General Studies,816,3606,4422,24,81,105,840,3687,4527
2021,Area of study: Technology,635,293,928,12,15,27,647,308,955
2021,Aeronautical and Aerospace Engineering,5386,812,6198,1128,297,1425,6514,1109,7623
2021,Painting,173,219,392,78,155,233,251,374,625
2021,Mine Surveying,17,9,26,8,2,10,25,11,36
2021,Mechanical Engineering,64441,8661,73102,18323,3202,21525,82764,11863,94627
2021,Materials Engineering,1063,391,1454,491,282,773,1554,673,2227
2021,Mathematics,25698,25136,50834,3560,2542,6102,29258,27678,56936
2021,Mechatronics,11190,1138,12328,6053,872,6925,17243,2010,19253
2021,Media Informatics,10653,5378,16031,1347,972,2319,12000,6350,18350
2021,Media Technology,4632,3262,7894,409,273,682,5041,3535,8576
2021,Media Economics/Media Management,4359,7623,11982,381,878,1259,4740,8501,13241
2021,Media Science,3757,8609,12366,402,959,1361,4159,9568,13727
2021,Medicine (General Medicine),32452,59244,91696,5674,7905,13579,38126,67149,105275
2021,Medical Informatics,1435,1131,2566,495,535,1030,1930,1666,3596
2021,Metals Technology,628,105,733,3,5,8,631,110,741
2021,Meteorology,541,394,935,82,78,160,623,472,1095
2021,Microelectronics,119,31,150,436,189,625,555,220,775
2021,Microsystems Technology,980,194,1174,972,287,1259,1952,481,2433
2021,Dairy Farming,34,21,55,8,21,29,42,42,84
2021,Mineralogy,108,49,157,43,15,58,151,64,215
2021,Medieval and Modern History,423,314,737,36,45,81,459,359,818
2021,Music Education,3284,4210,7494,304,605,909,3588,4815,8403
2021,Musicology/History of Music,1793,2044,3837,297,530,827,2090,2574,4664
2021,Nature Conservation,427,708,1135,163,271,434,590,979,1569
2021,Nautical Science/Maritime Studies,628,182,810,220,37,257,848,219,1067
2021,New Media,1096,1410,2506,244,298,542,1340,1708,3048
2021,Modern Greek,12,17,29,19,49,68,31,66,97
2021,Non-medical Healthcare Professions/Therapies,2647,11190,13837,210,720,930,2857,11910,14767
2021,Low German,1,2,3,,,,1,2,3
2021,Dutch,103,192,295,12,20,32,115,212,327
2021,"Nordic/Scand. St. (Nord. Phil., ind. lang. n.e.c.)",280,712,992,27,72,99,307,784,1091
2021,Optoelectronics,333,110,443,110,36,146,443,146,589
2021,Orchestral Music,308,327,635,501,649,1150,809,976,1785
2021,"Oriental Studies, Ancient Oriental Studies",382,540,922,127,134,261,509,674,1183
2021,MINT orientation studies,36,21,57,,,,36,21,57
2021,Eastern and South Eastern Europe Studies,139,208,347,57,98,155,196,306,502
2021,Oceanography,6,10,16,7,1,8,13,11,24
2021,Early Childhood Education,422,3252,3674,25,257,282,447,3509,3956
2021,Plant Production,346,274,620,37,32,69,383,306,689
2021,Nursing Science/Nursing Management,3169,10071,13240,181,631,812,3350,10702,14052
2021,Pharmacy,4097,9379,13476,902,1830,2732,4999,11209,16208
2021,Philosophy,8990,7374,16364,1248,1176,2424,10238,8550,18788
2021,Physics,28835,11564,40399,5366,2648,8014,34201,14212,48413
2021,Engineering Physics/Mechanical Process Engineering,1731,501,2232,761,152,913,2492,653,3145
2021,Political Science,15445,12634,28079,2116,2770,4886,17561,15404,32965
2021,Police/Protection of the Constitution,16772,9455,26227,113,73,186,16885,9528,26413
2021,Polish,22,33,55,5,15,20,27,48,75
2021,Portuguese,34,47,81,11,20,31,45,67,112
2021,Psychology,24096,72672,96768,1927,6396,8323,26023,79068,105091
2021,Spatial Planning,2381,2483,4864,503,823,1326,2884,3306,6190
2021,Administration of Justice,657,2307,2964,,1,1,657,2308,2965
2021,Law,46939,62200,109139,3280,6266,9546,50219,68466,118685
2021,Renewable Energy,1949,608,2557,936,236,1172,2885,844,3729
2021,Religious Studies,525,879,1404,145,152,297,670,1031,1701
2021,Restoration Studies,171,589,760,13,52,65,184,641,825
2021,Rhythmics,,19,19,2,2,4,2,21,23
2021,"Romance Studies (Rom. Phil., indiv. lang. n.e.c.)",497,1565,2062,206,583,789,703,2148,2851
2021,Russian,174,399,573,36,193,229,210,592,802
2021,General Studies (including School Garden),180,999,1179,10,63,73,190,1062,1252
2021,Drama Studies,213,259,472,52,73,125,265,332,597
2021,Naval Architecture/Ship Technology,588,92,680,252,41,293,840,133,973
2021,School Pedagogy,173,324,497,40,54,94,213,378,591
2021,Sinology/Korean Studies,872,1919,2791,194,590,784,1066,2509,3575
2021,Slavic Studies (Slavic Philology),321,615,936,92,345,437,413,960,1373
2021,Special Needs Education,3033,14901,17934,57,334,391,3090,15235,18325
2021,Other subjects,1069,1337,2406,816,866,1682,1885,2203,4088
2021,Other regional studies,146,249,395,33,108,141,179,357,536
2021,Other orientation studies,6,4,10,1,1,2,7,5,12
2021,Sorabistics,5,21,26,2,4,6,7,25,32
2021,Social Work,17364,58263,75627,1244,3794,5038,18608,62057,80665
2021,Social Studies,1697,1903,3600,84,122,206,1781,2025,3806
2021,Social Pedagogy,2117,9388,11505,57,390,447,2174,9778,11952
2021,Social Security Administration,741,1788,2529,65,72,137,806,1860,2666
2021,Applied Social Science,5506,18167,23673,379,1055,1434,5885,19222,25107
2021,Social Sciences,8127,11587,19714,961,1705,2666,9088,13292,22380
2021,Sociology,6128,11340,17468,671,1505,2176,6799,12845,19644
2021,Spanish,1020,2887,3907,211,643,854,1231,3530,4761
2021,Sports Management/Sports Economics,7325,2952,10277,543,161,704,7868,3113,10981
2021,Sports Education/Sports Psychology,6258,4240,10498,144,109,253,6402,4349,10751
2021,Sports Science,11665,7363,19028,827,551,1378,12492,7914,20406
2021,Steel Construction,64,8,72,6,,6,70,8,78
2021,Statistics,1783,1016,2799,1144,627,1771,2927,1643,4570
2021,"South Slavic (Bulgar., Serbo-Croat., Slovene etc.)",3,1,4,2,1,3,5,2,7
2021,Dance Education,28,128,156,76,162,238,104,290,394
2021,Technical Cybernetics,303,78,381,41,13,54,344,91,435
2021,Technomathematics,1686,498,2184,270,110,380,1956,608,2564
2021,Textile Design,545,2152,2697,83,397,480,628,2549,3177
2021,Textile and Clothing Technology/Industry,432,1807,2239,245,270,515,677,2077,2754
2021,Theatre Studies,687,1998,2685,92,299,391,779,2297,3076
2021,Veterinary Medicine,1000,6168,7168,156,538,694,1156,6706,7862
2021,Animal Production,90,222,312,22,23,45,112,245,357
2021,Sound Engineering,386,54,440,66,17,83,452,71,523
2021,Tourism Management,2024,6873,8897,463,947,1410,2487,7820,10307
2021,Transport and Conveying Technology,294,31,325,33,9,42,327,40,367
2021,Czech,5,14,19,4,24,28,9,38,47
2021,Turkish Studies,56,221,277,49,103,152,105,324,429
2021,Environmental Protection,871,952,1823,596,423,1019,1467,1375,2842
2021,Environmental Technology (including Recycling),3983,2514,6497,728,648,1376,4711,3162,7873
2021,Prehistory and Early History,442,498,940,35,42,77,477,540,1017
2021,Process Engineering,4695,2812,7507,1216,966,2182,5911,3778,9689
2021,Transport Engineering,3096,903,3999,961,301,1262,4057,1204,5261
2021,Transport Economics,993,392,1385,281,176,457,1274,568,1842
2021,Surveying (Geodesy),2851,1189,4040,766,387,1153,3617,1576,5193
2021,Supply Technology,2410,419,2829,292,86,378,2702,505,3207
2021,Administrative Science/Public Administration,7669,11331,19000,233,295,528,7902,11626,19528
2021,Folklore,258,738,996,26,109,135,284,847,1131
2021,Economics,11141,4927,16068,2478,2500,4978,13619,7427,21046
2021,Hydraulic Engineering,604,429,1033,209,168,377,813,597,1410
2021,Water Management,499,287,786,352,200,552,851,487,1338
2021,Viticulture and Oenology,660,400,1060,128,115,243,788,515,1303
2021,Handicrafts (technical)/Technology,155,263,418,3,23,26,158,286,444
2021,Handicrafts Education,34,79,113,,1,1,34,80,114
2021,Materials Technology,2468,846,3314,1187,522,1709,3655,1368,5023
2021,Western Slavic (general and n.e.c.),9,14,23,5,5,10,14,19,33
2021,Economic/Social Geography,251,235,486,7,13,20,258,248,506
2021,Economic/Social History,101,81,182,10,50,60,111,131,242
2021,Business Informatics,46653,11007,57660,6101,3551,9652,52754,14558,67312
2021,Business Engineering spec. in Engineering Sciences,43034,11410,54444,8971,3973,12944,52005,15383,67388
2021,Business Engineering specialising in Economics,20811,6770,27581,3042,1465,4507,23853,8235,32088
2021,Business Mathematics,3247,2015,5262,565,733,1298,3812,2748,6560
2021,Business and Economics Education,2479,3872,6351,87,246,333,2566,4118,6684
2021,Business Law,8323,11862,20185,641,1282,1923,8964,13144,22108
2021,Business and Economics,43134,33519,76653,5803,6943,12746,48937,40462,89399
2021,History of Science/History of Technology,21,9,30,2,1,3,23,10,33
2021,Dentistry,4223,8983,13206,1008,1278,2286,5231,10261,15492
2021,Customs and Tax Administration,2982,3752,6734,8,26,34,2990,3778,6768
2022,Waste Management,48,22,70,2,,2,50,22,72
2022,African Studies,381,645,1026,121,152,273,502,797,1299
2022,Agricultural Biology,328,325,653,269,272,541,597,597,1194
2022,Agricultural Economics,720,498,1218,453,319,772,1173,817,1990
2022,Agricultural Science/Agriculture,6619,6057,12676,1168,1265,2433,7787,7322,15109
2022,Egyptology,270,377,647,30,51,81,300,428,728
2022,General Linguistics/Indo-European Studies,1195,3181,4376,337,942,1279,1532,4123,5655
2022,General Literary Studies,739,3130,3869,142,508,650,881,3638,4519
2022,Ancient History,127,94,221,18,17,35,145,111,256
2022,American Studies,622,1383,2005,423,690,1113,1045,2073,3118
2022,Applied Art,1283,2522,3805,164,391,555,1447,2913,4360
2022,Applied Linguistics,879,3111,3990,248,764,1012,1127,3875,5002
2022,Applied Systems Science,1642,474,2116,799,277,1076,2441,751,3192
2022,English Studies,12626,30016,42642,1517,4312,5829,14143,34328,48471
2022,Anthropology (Human Biology),91,337,428,74,165,239,165,502,667
2022,Arabic/Arabic Studies,129,270,399,97,98,195,226,368,594
2022,Work Studies/Business Studies,834,1168,2002,38,72,110,872,1240,2112
2022,Occupational Guidance and Career Counselling,170,449,619,5,9,14,175,458,633
2022,Labour Administration,297,633,930,6,7,13,303,640,943
2022,Archaeology,2589,2992,5581,196,307,503,2785,3299,6084
2022,Archaeometry (Archaeological Engineering),18,10,28,2,3,5,20,13,33
2022,Architecture,14682,19261,33943,3095,4671,7766,17777,23932,41709
2022,Archive and Documentation Science,141,264,405,16,43,59,157,307,464
2022,Archive Studies,170,210,380,4,4,8,174,214,388
2022,Asian Languages and Cultures/Asian Studies,398,939,1337,228,458,686,626,1397,2023
2022,Astrophysics and Astronomy,184,77,261,251,146,397,435,223,658
2022,Ophthalmic Optics,234,516,750,22,59,81,256,575,831
2022,Immigrant Education,14,101,115,30,57,87,44,158,202
2022,Non-Europ. Lang. and Cult. in Oceania and America,61,102,163,25,57,82,86,159,245
2022,Foreign Affairs Administration,130,149,279,3,,3,133,149,282
2022,Baltic Studies,2,6,8,,3,3,2,9,11
2022,Banking,463,302,765,14,17,31,477,319,796
2022,Civil Engineering/Structural Engineering,32134,13958,46092,8464,3332,11796,40598,17290,57888
2022,Mining/Mine Engineering,672,216,888,806,264,1070,1478,480,1958
2022,Occupation-specific Foreign Language Training,361,743,1104,90,172,262,451,915,1366
2022,"Vocational, Business and Economics Education",729,1326,2055,82,105,187,811,1431,2242
2022,Business Administration,110763,93471,204234,16283,17064,33347,127046,110535,237581
2022,Librarianship,15,37,52,,1,1,15,38,53
2022,Fine Arts/Graphics,1145,1666,2811,450,874,1324,1595,2540,4135
2022,Sculpting/Statuary Art,99,163,262,74,109,183,173,272,445
2022,Biochemistry,2927,4304,7231,653,1147,1800,3580,5451,9031
2022,Bioinformatics,1214,860,2074,376,451,827,1590,1311,2901
2022,Biology,16523,31511,48034,2965,5755,8720,19488,37266,56754
2022,Biomedicine,541,1583,2124,308,511,819,849,2094,2943
2022,Biotechnology,4365,6014,10379,1256,1930,3186,5621,7944,13565
2022,Brewing Science/Beverage Technology,439,110,549,60,20,80,499,130,629
2022,Armed Forces Administration,212,308,520,,,,212,308,520
2022,Byzantine Studies,4,12,16,18,8,26,22,20,42
2022,Caritas Science,22,62,84,8,6,14,30,68,98
2022,Chemistry,19871,13995,33866,3245,3709,6954,23116,17704,40820
2022,Chemical Engineering/Chemical Process Technology,4365,2306,6671,1087,859,1946,5452,3165,8617
2022,Computer Linguistics,696,623,1319,339,598,937,1035,1221,2256
2022,Computer and Communication Technology,3243,2006,5249,858,559,1417,4101,2565,6666
2022,Danish,20,54,74,,1,1,20,55,75
2022,Performing Arts/Stagecraft/Directing,383,903,1286,126,330,456,509,1233,1742
2022,German as a Foreign or Second Language,378,2080,2458,359,1251,1610,737,3331,4068
2022,Pastoral Care Studies,95,136,231,14,18,32,109,154,263
2022,Conducting,116,56,172,97,83,180,213,139,352
2022,Printing and Reproduction Technology,567,757,1324,106,94,200,673,851,1524
2022,Gemstone and Jewellery Design,8,23,31,9,33,42,17,56,73
2022,Electrical Power Engineering,1108,198,1306,482,147,629,1590,345,1935
2022,Electrical Engineering/Electronics,35501,4552,40053,18067,4755,22822,53568,9307,62875
2022,Energy Process Engineering,3627,894,4521,1080,333,1413,4707,1227,5934
2022,Nutritional Science,1066,5154,6220,154,740,894,1220,5894,7114
2022,Adult Education and Extracurricular Youth Educat.,544,1838,2382,27,131,158,571,1969,2540
2022,Educational Science (Pedagogy),12361,44034,56395,785,3461,4246,13146,47495,60641
2022,Ethics,358,829,1187,45,85,130,403,914,1317
2022,Ethnology,852,2197,3049,280,445,725,1132,2642,3774
2022,European Ethnology and Cultural Studies,742,2186,2928,213,457,670,955,2643,3598
2022,European Economic Studies,792,959,1751,168,209,377,960,1168,2128
2022,"Protestant Religious Pedagogy, Church Educat. Work",195,431,626,4,9,13,199,440,639
2022,"Protestant Theology, Protes. Religious Education",3422,5097,8519,354,219,573,3776,5316,9092
2022,Facility Management,2104,1384,3488,95,70,165,2199,1454,3653
2022,Automotive Technology,8140,597,8737,2605,258,2863,10745,855,11600
2022,Precision Engineering,464,52,516,85,31,116,549,83,632
2022,Manufacturing Technology/Production Engineering,3309,551,3860,1314,273,1587,4623,824,5447
2022,Film and Television Studies,1280,1047,2327,237,307,544,1517,1354,2871
2022,Financial Administration,937,1251,2188,5,5,10,942,1256,2198
2022,Finno-Ugrian Studies,42,69,111,3,7,10,45,76,121
2022,"Forest Science, Forestry",3685,2120,5805,468,362,830,4153,2482,6635
2022,French,808,3317,4125,161,499,660,969,3816,4785
2022,Horticulture,1086,863,1949,79,73,152,1165,936,2101
2022,Geography,9775,10322,20097,576,639,1215,10351,10961,21312
2022,Geology/Palaeontology,166,140,306,75,53,128,241,193,434
2022,Geoecology,518,648,1166,61,80,141,579,728,1307
2022,Geophysics,867,843,1710,120,110,230,987,953,1940
2022,Geosciences general,4580,3610,8190,1048,735,1783,5628,4345,9973
2022,German Studies/German,12764,47246,60010,1136,4349,5485,13900,51595,65495
2022,Singing,251,409,660,276,396,672,527,805,1332
2022,History,17298,13145,30443,1302,1342,2644,18600,14487,33087
2022,Health Education,1354,5148,6502,52,206,258,1406,5354,6760
2022,Health Technology,4657,4782,9439,2505,2046,4551,7162,6828,13990
2022,Health Science/Health Management,9445,26685,36130,988,2674,3662,10433,29359,39792
2022,Glass Technology/Ceramics,72,37,109,10,8,18,82,45,127
2022,Graphic Design/Communication Design,7603,14847,22450,1464,3039,4503,9067,17886,26953
2022,Greek,159,138,297,41,36,77,200,174,374
2022,Primary School Education/Primary Level Education,1622,8205,9827,28,195,223,1650,8400,10050
2022,Domestic and Nutritional Sciences,1199,5115,6314,191,442,633,1390,5557,6947
2022,Domestic Science,34,120,154,1,1,2,35,121,156
2022,Wood and Fibre Technology,627,115,742,34,5,39,661,120,781
2022,Timber Construction,508,99,607,19,6,25,527,105,632
2022,Wood Science,135,23,158,34,18,52,169,41,210
2022,Metallurgy and Foundry,315,87,402,217,79,296,532,166,698
2022,Indology,35,67,102,19,30,49,54,97,151
2022,Industrial Design/Product Design,1806,1744,3550,319,444,763,2125,2188,4313
2022,Computer Science,90141,18486,108627,25422,9533,34955,115563,28019,143582
2022,Inf./Library Scien. (not at univ. of app.adm.sci.),832,1913,2745,62,133,195,894,2046,2940
2022,Computational Engineer./Technical Computer Science,9696,1657,11353,3794,1140,4934,13490,2797,16287
2022,Interior Architecture,471,3663,4134,90,523,613,561,4186,4747
2022,Internal Administration,2469,5024,7493,18,46,64,2487,5070,7557
2022,Instrumental Music,1206,1085,2291,2126,2511,4637,3332,3596,6928
2022,Interdisc. Studies (specialising in Engineering),11260,3942,15202,3575,1422,4997,14835,5364,20199
2022,Interdisc. Studies (special. in Natural Sciences),3312,3593,6905,1658,1454,3112,4970,5047,10017
2022,"Interdisc. St. (spec. in Law, Econ. and Soc. Sci.)",6586,8005,14591,1230,1797,3027,7816,9802,17618
2022,Interdisc. Studies (spec. in Humanities),4955,11718,16673,1157,2778,3935,6112,14496,20608
2022,"Interdisc. Studies (special. in Art, Art Theory)",251,602,853,186,254,440,437,856,1293
2022,International Business Studies/Management,15371,19118,34489,7425,8064,15489,22796,27182,49978
2022,Iranian Studies,53,62,115,44,54,98,97,116,213
2022,Islamic Studies/Islamic theology,373,485,858,120,104,224,493,589,1082
2022,Islamic Studies,302,634,936,130,136,266,432,770,1202
2022,Italian,200,505,705,73,282,355,273,787,1060
2022,Japanese Studies,1235,1538,2773,154,274,428,1389,1812,3201
2022,Jazz and Popular Music,930,347,1277,187,75,262,1117,422,1539
2022,Judaic Studies/Hebrew,167,245,412,43,68,111,210,313,523
2022,Law Enforcement,67,108,175,,,,67,108,175
2022,Cartography,113,72,185,64,44,108,177,116,293
2022,"Catholic Religious Pedagogy, Church Educat. Work",118,223,341,63,90,153,181,313,494
2022,"Catholic Theology, Catholic Religious Education",2390,3233,5623,392,151,543,2782,3384,6166
2022,Caucasian Studies,3,1,4,,4,4,3,5,8
2022,Church Music,285,115,400,37,46,83,322,161,483
2022,Classical Philology,130,162,292,29,32,61,159,194,353
2022,"Communication Technology, Information Engineering",4106,626,4732,2304,824,3128,6410,1450,7860
2022,Communication Science/Journalism,4650,11715,16365,410,1158,1568,5060,12873,17933
2022,Composition,150,34,184,147,122,269,297,156,453
2022,Arts Education,961,4624,5585,107,448,555,1068,5072,6140
2022,"Art History, Art Theory",1960,7368,9328,219,1010,1229,2179,8378,10557
2022,Plastics Technology,523,124,647,75,25,100,598,149,747
2022,Land Management Engineering/Landscape Design,2007,2889,4896,110,253,363,2117,3142,5259
2022,Landscape Ecology/Biogeography (ex. SF385 s. 2012),495,742,1237,27,38,65,522,780,1302
2022,Latin,707,944,1651,33,41,74,740,985,1725
2022,Latin America Studies,96,208,304,51,94,145,147,302,449
2022,Food Chemistry,640,1360,2000,62,151,213,702,1511,2213
2022,Food Technology,1362,1708,3070,152,298,450,1514,2006,3520
2022,Area of study: Humanities,1302,7230,8532,60,193,253,1362,7423,8785
2022,Area of study: Social Studies,196,228,424,5,1,6,201,229,430
2022,Area of study: Natural Sciences/General Studies,930,3897,4827,19,89,108,949,3986,4935
2022,Area of study: Technology,629,266,895,12,10,22,641,276,917
2022,Aeronautical and Aerospace Engineering,5169,781,5950,1249,340,1589,6418,1121,7539
2022,Painting,216,315,531,77,149,226,293,464,757
2022,Mine Surveying,18,12,30,7,4,11,25,16,41
2022,Mechanical Engineering,58624,8133,66757,17725,3267,20992,76349,11400,87749
2022,Materials Engineering,997,359,1356,596,325,921,1593,684,2277
2022,Mathematics,25036,24595,49631,3686,2556,6242,28722,27151,55873
2022,Mechatronics,10351,1067,11418,6047,877,6924,16398,1944,18342
2022,Media Informatics,10167,5322,15489,1384,1040,2424,11551,6362,17913
2022,Media Technology,4416,3096,7512,428,280,708,4844,3376,8220
2022,Media Economics/Media Management,4160,7346,11506,423,921,1344,4583,8267,12850
2022,Media Science,3734,8659,12393,405,1026,1431,4139,9685,13824
2022,Medicine (General Medicine),32908,61452,94360,5625,8145,13770,38533,69597,108130
2022,Medical Informatics,1392,1135,2527,561,595,1156,1953,1730,3683
2022,Metals Technology,563,101,664,6,5,11,569,106,675
2022,Meteorology,550,415,965,98,85,183,648,500,1148
2022,Microelectronics,136,42,178,631,258,889,767,300,1067
2022,Microsystems Technology,936,182,1118,1068,290,1358,2004,472,2476
2022,Dairy Farming,25,21,46,5,17,22,30,38,68
2022,Mineralogy,98,41,139,48,21,69,146,62,208
2022,Medieval and Modern History,366,299,665,32,38,70,398,337,735
2022,Music Education,3297,4141,7438,294,644,938,3591,4785,8376
2022,Musicology/History of Music,1693,1914,3607,289,539,828,1982,2453,4435
2022,Nature Conservation,410,712,1122,181,262,443,591,974,1565
2022,Nautical Science/Maritime Studies,620,165,785,207,36,243,827,201,1028
2022,New Media,1145,1454,2599,258,317,575,1403,1771,3174
2022,Modern Greek,14,22,36,13,49,62,27,71,98
2022,Non-medical Healthcare Professions/Therapies,2732,12823,15555,220,761,981,2952,13584,16536
2022,Low German,1,5,6,,,,1,5,6
2022,Dutch,96,185,281,13,19,32,109,204,313
2022,"Nordic/Scand. St. (Nord. Phil., ind. lang. n.e.c.)",293,741,1034,22,49,71,315,790,1105
2022,Optoelectronics,279,112,391,104,34,138,383,146,529
2022,Orchestral Music,300,294,594,494,647,1141,794,941,1735
2022,"Oriental Studies, Ancient Oriental Studies",351,530,881,132,137,269,483,667,1150
2022,MINT orientation studies,3,2,5,,,,3,2,5
2022,Eastern and South Eastern Europe Studies,123,186,309,40,89,129,163,275,438
2022,Oceanography,3,3,6,9,5,14,12,8,20
2022,Early Childhood Education,402,3197,3599,23,241,264,425,3438,3863
2022,Plant Production,343,323,666,29,22,51,372,345,717
2022,Nursing Science/Nursing Management,3181,9972,13153,201,660,861,3382,10632,14014
2022,Pharmacy,3946,9219,13165,903,1996,2899,4849,11215,16064
2022,Philosophy,8902,7444,16346,1216,1153,2369,10118,8597,18715
2022,Physics,28220,11698,39918,5806,2893,8699,34026,14591,48617
2022,Engineering Physics/Mechanical Process Engineering,1637,472,2109,736,162,898,2373,634,3007
2022,Political Science,14958,12378,27336,2168,2839,5007,17126,15217,32343
2022,Police/Protection of the Constitution,15858,9436,25294,182,96,278,16040,9532,25572
2022,Polish,20,27,47,5,15,20,25,42,67
2022,Portuguese,26,43,69,8,20,28,34,63,97
2022,Psychology,24802,77085,101887,2035,6980,9015,26837,84065,110902
2022,Spatial Planning,2468,2486,4954,532,862,1394,3000,3348,6348
2022,Administration of Justice,643,2404,3047,,2,2,643,2406,3049
2022,Law,45433,61809,107242,3279,6162,9441,48712,67971,116683
2022,Renewable Energy,2021,670,2691,1037,264,1301,3058,934,3992
2022,Religious Studies,473,806,1279,157,165,322,630,971,1601
2022,Restoration Studies,147,586,733,11,49,60,158,635,793
2022,Rhythmics,1,7,8,1,8,9,2,15,17
2022,"Romance Studies (Rom. Phil., indiv. lang. n.e.c.)",483,1399,1882,177,563,740,660,1962,2622
2022,Russian,153,319,472,27,173,200,180,492,672
2022,General Studies (including School Garden),210,1127,1337,13,57,70,223,1184,1407
2022,Drama Studies,225,278,503,62,96,158,287,374,661
2022,Naval Architecture/Ship Technology,528,87,615,228,47,275,756,134,890
2022,School Pedagogy,152,305,457,23,49,72,175,354,529
2022,Sinology/Korean Studies,806,1781,2587,213,561,774,1019,2342,3361
2022,Slavic Studies (Slavic Philology),323,580,903,150,380,530,473,960,1433
2022,Special Needs Education,3090,14837,17927,58,334,392,3148,15171,18319
2022,Other subjects,921,1434,2355,774,942,1716,1695,2376,4071
2022,Other regional studies,119,226,345,32,115,147,151,341,492
2022,Other orientation studies,34,15,49,15,16,31,49,31,80
2022,Sorabistics,5,17,22,2,5,7,7,22,29
2022,Social Work,18073,60770,78843,1245,3963,5208,19318,64733,84051
2022,Social Studies,1883,1876,3759,111,118,229,1994,1994,3988
2022,Social Pedagogy,2163,9617,11780,62,420,482,2225,10037,12262
2022,Social Security Administration,767,1830,2597,61,72,133,828,1902,2730
2022,Applied Social Science,5544,17629,23173,362,1019,1381,5906,18648,24554
2022,Social Sciences,7851,11364,19215,953,1682,2635,8804,13046,21850
2022,Sociology,5852,11183,17035,651,1505,2156,6503,12688,19191
2022,Spanish,951,2663,3614,193,626,819,1144,3289,4433
2022,Sports Management/Sports Economics,7546,2842,10388,577,160,737,8123,3002,11125
2022,Sports Education/Sports Psychology,5615,3681,9296,179,92,271,5794,3773,9567
2022,Sports Science,12108,7649,19757,856,597,1453,12964,8246,21210
2022,Steel Construction,47,3,50,3,1,4,50,4,54
2022,Statistics,2024,1071,3095,1109,664,1773,3133,1735,4868
2022,"South Slavic (Bulgar., Serbo-Croat., Slovene etc.)",3,4,7,1,1,2,4,5,9
2022,Dance Education,30,121,151,63,150,213,93,271,364
2022,Technical Cybernetics,266,74,340,38,15,53,304,89,393
2022,Technomathematics,1698,510,2208,374,167,541,2072,677,2749
2022,Textile Design,593,2078,2671,89,401,490,682,2479,3161
2022,Textile and Clothing Technology/Industry,435,1521,1956,261,247,508,696,1768,2464
2022,Theatre Studies,689,1964,2653,86,266,352,775,2230,3005
2022,Veterinary Medicine,980,6261,7241,153,547,700,1133,6808,7941
2022,Animal Production,73,188,261,19,17,36,92,205,297
2022,Sound Engineering,371,62,433,80,17,97,451,79,530
2022,Tourism Management,1975,6460,8435,452,888,1340,2427,7348,9775
2022,Transport and Conveying Technology,258,29,287,25,9,34,283,38,321
2022,Czech,7,16,23,3,13,16,10,29,39
2022,Turkish Studies,58,209,267,46,88,134,104,297,401
2022,Environmental Protection,802,949,1751,561,443,1004,1363,1392,2755
2022,Environmental Technology (including Recycling),3821,2414,6235,799,674,1473,4620,3088,7708
2022,Prehistory and Early History,414,480,894,31,52,83,445,532,977
2022,Process Engineering,4346,2673,7019,1171,979,2150,5517,3652,9169
2022,Transport Engineering,2912,786,3698,913,283,1196,3825,1069,4894
2022,Transport Economics,886,360,1246,232,163,395,1118,523,1641
2022,Surveying (Geodesy),2873,1184,4057,801,408,1209,3674,1592,5266
2022,Supply Technology,2389,427,2816,322,88,410,2711,515,3226
2022,Administrative Science/Public Administration,7636,11270,18906,345,347,692,7981,11617,19598
2022,Folklore,241,676,917,28,118,146,269,794,1063
2022,Economics,10556,4639,15195,2743,2798,5541,13299,7437,20736
2022,Hydraulic Engineering,536,390,926,201,171,372,737,561,1298
2022,Water Management,453,289,742,355,207,562,808,496,1304
2022,Viticulture and Oenology,613,355,968,116,124,240,729,479,1208
2022,Handicrafts (technical)/Technology,162,260,422,4,22,26,166,282,448
2022,Handicrafts Education,40,82,122,1,1,2,41,83,124
2022,Materials Technology,2191,797,2988,1238,578,1816,3429,1375,4804
2022,Western Slavic (general and n.e.c.),12,16,28,4,4,8,16,20,36
2022,Economic/Social Geography,232,237,469,5,16,21,237,253,490
2022,Economic/Social History,98,69,167,16,41,57,114,110,224
2022,Business Informatics,45471,10631,56102,6315,3715,10030,51786,14346,66132
2022,Business Engineering spec. in Engineering Sciences,39537,10442,49979,9361,3945,13306,48898,14387,63285
2022,Business Engineering specialising in Economics,19377,6227,25604,2800,1376,4176,22177,7603,29780
2022,Business Mathematics,3034,1867,4901,559,698,1257,3593,2565,6158
2022,Business and Economics Education,2436,3722,6158,76,227,303,2512,3949,6461
2022,Business Law,7899,11922,19821,641,1258,1899,8540,13180,21720
2022,Business and Economics,41654,32705,74359,6252,7146,13398,47906,39851,87757
2022,History of Science/History of Technology,22,9,31,2,,2,24,9,33
2022,Dentistry,4193,9151,13344,1025,1305,2330,5218,10456,15674
2022,Customs and Tax Administration,3348,3990,7338,15,32,47,3363,4022,7385
2023,Waste Management,42,18,60,2,1,3,44,19,63
2023,African Studies,381,612,993,118,161,279,499,773,1272
2023,Agricultural Biology,288,280,568,275,277,552,563,557,1120
2023,Agricultural Economics,627,453,1080,471,312,783,1098,765,1863
2023,Agricultural Science/Agriculture,6275,5787,12062,1233,1330,2563,7508,7117,14625
2023,Egyptology,268,400,668,22,45,67,290,445,735
2023,General Linguistics/Indo-European Studies,1054,2850,3904,388,980,1368,1442,3830,5272
2023,General Literary Studies,732,3159,3891,145,510,655,877,3669,4546
2023,Ancient History,108,100,208,21,18,39,129,118,247
2023,American Studies,612,1395,2007,449,738,1187,1061,2133,3194
2023,Applied Art,1235,2537,3772,138,392,530,1373,2929,4302
2023,Applied Linguistics,831,2858,3689,231,724,955,1062,3582,4644
2023,Applied Systems Science,1567,464,2031,1054,353,1407,2621,817,3438
2023,English Studies,12511,30191,42702,1607,4327,5934,14118,34518,48636
2023,Anthropology (Human Biology),91,342,433,74,167,241,165,509,674
2023,Arabic/Arabic Studies,112,244,356,85,85,170,197,329,526
2023,Work Studies/Business Studies,767,1070,1837,37,65,102,804,1135,1939
2023,Occupational Guidance and Career Counselling,171,436,607,6,6,12,177,442,619
2023,Labour Administration,314,597,911,7,5,12,321,602,923
2023,Archaeology,2473,2887,5360,260,420,680,2733,3307,6040
2023,Archaeometry (Archaeological Engineering),18,10,28,1,2,3,19,12,31
2023,Architecture,14399,19977,34376,2936,4616,7552,17335,24593,41928
2023,Archive and Documentation Science,130,277,407,16,41,57,146,318,464
2023,Archive Studies,175,229,404,2,7,9,177,236,413
2023,Asian Languages and Cultures/Asian Studies,393,849,1242,251,418,669,644,1267,1911
2023,Astrophysics and Astronomy,190,84,274,274,136,410,464,220,684
2023,Ophthalmic Optics,236,507,743,27,56,83,263,563,826
2023,Immigrant Education,16,90,106,27,50,77,43,140,183
2023,Non-Europ. Lang. and Cult. in Oceania and America,50,85,135,25,53,78,75,138,213
2023,Foreign Affairs Administration,147,142,289,10,,10,157,142,299
2023,Baltic Studies,3,5,8,,3,3,3,8,11
2023,Banking,412,245,657,22,29,51,434,274,708
2023,Civil Engineering/Structural Engineering,31731,13575,45306,8576,3469,12045,40307,17044,57351
2023,Mining/Mine Engineering,594,191,785,995,275,1270,1589,466,2055
2023,Occupation-specific Foreign Language Training,312,663,975,63,138,201,375,801,1176
2023,"Vocational, Business and Economics Education",772,1561,2333,113,106,219,885,1667,2552
2023,Business Administration,107147,89968,197115,17419,17941,35360,124566,107909,232475
2023,Librarianship,14,44,58,,,,14,44,58
2023,Fine Arts/Graphics,1151,1705,2856,420,881,1301,1571,2586,4157
2023,Sculpting/Statuary Art,105,163,268,70,104,174,175,267,442
2023,Biochemistry,2780,4257,7037,630,1213,1843,3410,5470,8880
2023,Bioinformatics,1153,889,2042,414,500,914,1567,1389,2956
2023,Biology,16259,31813,48072,3070,6047,9117,19329,37860,57189
2023,Biomedicine,510,1631,2141,289,516,805,799,2147,2946
2023,Biotechnology,4165,6072,10237,1358,2050,3408,5523,8122,13645
2023,Brewing Science/Beverage Technology,369,101,470,53,15,68,422,116,538
2023,Armed Forces Administration,239,315,554,,,,239,315,554
2023,Byzantine Studies,3,11,14,17,10,27,20,21,41
2023,Caritas Science,22,51,73,10,8,18,32,59,91
2023,Chemistry,17994,12750,30744,3225,3874,7099,21219,16624,37843
2023,Chemical Engineering/Chemical Process Technology,4162,2295,6457,1125,926,2051,5287,3221,8508
2023,Computer Linguistics,619,533,1152,432,663,1095,1051,1196,2247
2023,Computer and Communication Technology,3238,2084,5322,948,641,1589,4186,2725,6911
2023,Danish,19,50,69,,2,2,19,52,71
2023,Performing Arts/Stagecraft/Directing,378,921,1299,124,338,462,502,1259,1761
2023,German as a Foreign or Second Language,362,1969,2331,338,1153,1491,700,3122,3822
2023,Pastoral Care Studies,70,124,194,22,27,49,92,151,243
2023,Conducting,87,57,144,93,74,167,180,131,311
2023,Printing and Reproduction Technology,546,740,1286,103,104,207,649,844,1493
2023,Gemstone and Jewellery Design,9,34,43,8,34,42,17,68,85
2023,Electrical Power Engineering,938,176,1114,453,134,587,1391,310,1701
2023,Electrical Engineering/Electronics,33468,4117,37585,17994,4751,22745,51462,8868,60330
2023,Energy Process Engineering,3320,823,4143,1152,338,1490,4472,1161,5633
2023,Nutritional Science,1048,5138,6186,147,753,900,1195,5891,7086
2023,Adult Education and Extracurricular Youth Educat.,523,1665,2188,26,113,139,549,1778,2327
2023,Educational Science (Pedagogy),12299,43628,55927,751,3338,4089,13050,46966,60016
2023,Ethics,323,685,1008,43,65,108,366,750,1116
2023,Ethnology,733,1980,2713,257,438,695,990,2418,3408
2023,European Ethnology and Cultural Studies,714,2071,2785,186,423,609,900,2494,3394
2023,European Economic Studies,733,914,1647,183,231,414,916,1145,2061
2023,"Protestant Religious Pedagogy, Church Educat. Work",186,407,593,4,10,14,190,417,607
2023,"Protestant Theology, Protes. Religious Education",2957,4441,7398,313,201,514,3270,4642,7912
2023,Facility Management,1992,1392,3384,89,75,164,2081,1467,3548
2023,Automotive Technology,7358,546,7904,2685,273,2958,10043,819,10862
2023,Precision Engineering,431,45,476,76,8,84,507,53,560
2023,Manufacturing Technology/Production Engineering,2901,524,3425,1259,253,1512,4160,777,4937
2023,Film and Television Studies,1229,1082,2311,264,326,590,1493,1408,2901
2023,Financial Administration,977,1196,2173,3,8,11,980,1204,2184
2023,Finno-Ugrian Studies,32,64,96,5,5,10,37,69,106
2023,"Forest Science, Forestry",3630,2153,5783,417,364,781,4047,2517,6564
2023,French,764,2944,3708,151,444,595,915,3388,4303
2023,Horticulture,1037,797,1834,74,70,144,1111,867,1978
2023,Geography,9725,10185,19910,585,655,1240,10310,10840,21150
2023,Geology/Palaeontology,163,138,301,72,52,124,235,190,425
2023,Geoecology,514,649,1163,57,86,143,571,735,1306
2023,Geophysics,636,574,1210,157,113,270,793,687,1480
2023,Geosciences general,4244,3338,7582,1038,738,1776,5282,4076,9358
2023,German Studies/German,12190,45920,58110,1068,4041,5109,13258,49961,63219
2023,Singing,253,400,653,296,404,700,549,804,1353
2023,History,16540,12535,29075,1243,1263,2506,17783,13798,31581
2023,Health Education,1312,5019,6331,63,252,315,1375,5271,6646
2023,Health Technology,4410,4627,9037,2282,2073,4355,6692,6700,13392
2023,Health Science/Health Management,9119,25955,35074,1047,2784,3831,10166,28739,38905
2023,Glass Technology/Ceramics,62,31,93,8,5,13,70,36,106
2023,Graphic Design/Communication Design,7537,15538,23075,1444,3212,4656,8981,18750,27731
2023,Greek,156,118,274,41,34,75,197,152,349
2023,Primary School Education/Primary Level Education,1826,8908,10734,33,215,248,1859,9123,10982
2023,Domestic and Nutritional Sciences,1114,4736,5850,205,394,599,1319,5130,6449
2023,Domestic Science,31,110,141,1,,1,32,110,142
2023,Wood and Fibre Technology,635,142,777,24,8,32,659,150,809
2023,Timber Construction,498,103,601,14,4,18,512,107,619
2023,Wood Science,143,39,182,29,19,48,172,58,230
2023,Metallurgy and Foundry,247,63,310,166,56,222,413,119,532
2023,Indology,30,53,83,21,27,48,51,80,131
2023,Industrial Design/Product Design,1790,1754,3544,322,414,736,2112,2168,4280
2023,Computer Science,88878,17724,106602,28720,10848,39568,117598,28572,146170
2023,Inf./Library Scien. (not at univ. of app.adm.sci.),556,1837,2393,41,122,163,597,1959,2556
2023,Computational Engineer./Technical Computer Science,9064,1380,10444,3959,1225,5184,13023,2605,15628
2023,Interior Architecture,451,3562,4013,93,485,578,544,4047,4591
2023,Internal Administration,2461,4836,7297,19,40,59,2480,4876,7356
2023,Instrumental Music,1145,1083,2228,2129,2517,4646,3274,3600,6874
2023,Interdisc. Studies (specialising in Engineering),11063,4000,15063,4088,1562,5650,15151,5562,20713
2023,Interdisc. Studies (special. in Natural Sciences),3213,3559,6772,1693,1537,3230,4906,5096,10002
2023,"Interdisc. St. (spec. in Law, Econ. and Soc. Sci.)",6940,8071,15011,1340,1941,3281,8280,10012,18292
2023,Interdisc. Studies (spec. in Humanities),4893,11530,16423,1231,2838,4069,6124,14368,20492
2023,"Interdisc. Studies (special. in Art, Art Theory)",212,595,807,140,253,393,352,848,1200
2023,International Business Studies/Management,14496,18208,32704,7701,8267,15968,22197,26475,48672
2023,Iranian Studies,41,58,99,48,65,113,89,123,212
2023,Islamic Studies/Islamic theology,342,459,801,130,116,246,472,575,1047
2023,Islamic Studies,261,556,817,113,127,240,374,683,1057
2023,Italian,169,434,603,76,254,330,245,688,933
2023,Japanese Studies,1155,1419,2574,143,253,396,1298,1672,2970
2023,Jazz and Popular Music,990,357,1347,190,94,284,1180,451,1631
2023,Judaic Studies/Hebrew,143,198,341,51,76,127,194,274,468
2023,Law Enforcement,68,115,183,,,,68,115,183
2023,Cartography,106,102,208,48,52,100,154,154,308
2023,"Catholic Religious Pedagogy, Church Educat. Work",94,184,278,84,108,192,178,292,470
2023,"Catholic Theology, Catholic Religious Education",2051,2860,4911,407,129,536,2458,2989,5447
2023,Caucasian Studies,1,2,3,,3,3,1,5,6
2023,Church Music,269,109,378,36,58,94,305,167,472
2023,Classical Philology,124,140,264,24,30,54,148,170,318
2023,"Communication Technology, Information Engineering",3900,578,4478,2493,946,3439,6393,1524,7917
2023,Communication Science/Journalism,4413,11658,16071,391,1128,1519,4804,12786,17590
2023,Composition,141,46,187,141,121,262,282,167,449
2023,Arts Education,947,4748,5695,108,442,550,1055,5190,6245
2023,"Art History, Art Theory",1901,7014,8915,210,975,1185,2111,7989,10100
2023,Plastics Technology,421,106,527,56,18,74,477,124,601
2023,Land Management Engineering/Landscape Design,1934,2864,4798,120,243,363,2054,3107,5161
2023,Landscape Ecology/Biogeography (ex. SF385 s. 2012),520,763,1283,22,37,59,542,800,1342
2023,Latin,622,871,1493,31,40,71,653,911,1564
2023,Latin America Studies,80,190,270,49,87,136,129,277,406
2023,Food Chemistry,582,1210,1792,51,158,209,633,1368,2001
2023,Food Technology,1175,1500,2675,161,295,456,1336,1795,3131
2023,Area of study: Humanities,1341,7327,8668,39,184,223,1380,7511,8891
2023,Area of study: Social Studies,196,229,425,5,6,11,201,235,436
2023,Area of study: Natural Sciences/General Studies,1091,4325,5416,22,88,110,1113,4413,5526
2023,Area of study: Technology,605,232,837,9,5,14,614,237,851
2023,Aeronautical and Aerospace Engineering,5020,786,5806,1315,371,1686,6335,1157,7492
2023,Painting,205,331,536,63,143,206,268,474,742
2023,Mine Surveying,17,10,27,15,4,19,32,14,46
2023,Mechanical Engineering,53914,7484,61398,17065,3183,20248,70979,10667,81646
2023,Materials Engineering,891,360,1251,912,350,1262,1803,710,2513
2023,Mathematics,23044,22053,45097,3721,2520,6241,26765,24573,51338
2023,Mechatronics,9692,1073,10765,5755,824,6579,15447,1897,17344
2023,Media Informatics,9384,5181,14565,1346,1043,2389,10730,6224,16954
2023,Media Technology,4253,2992,7245,525,352,877,4778,3344,8122
2023,Media Economics/Media Management,3770,7031,10801,394,876,1270,4164,7907,12071
2023,Media Science,3445,8444,11889,406,1003,1409,3851,9447,13298
2023,Medicine (General Medicine),34427,64638,99065,5712,8606,14318,40139,73244,113383
2023,Medical Informatics,1312,1049,2361,540,649,1189,1852,1698,3550
2023,Metals Technology,465,79,544,8,5,13,473,84,557
2023,Meteorology,519,360,879,109,81,190,628,441,1069
2023,Microelectronics,57,15,72,248,124,372,305,139,444
2023,Microsystems Technology,887,167,1054,1014,272,1286,1901,439,2340
2023,Dairy Farming,29,24,53,5,12,17,34,36,70
2023,Mineralogy,85,49,134,34,29,63,119,78,197
2023,Medieval and Modern History,405,327,732,34,42,76,439,369,808
2023,Music Education,3246,4059,7305,322,636,958,3568,4695,8263
2023,Musicology/History of Music,1541,1898,3439,294,540,834,1835,2438,4273
2023,Nature Conservation,416,674,1090,214,264,478,630,938,1568
2023,Nautical Science/Maritime Studies,617,160,777,196,27,223,813,187,1000
2023,New Media,1155,1471,2626,254,348,602,1409,1819,3228
2023,Modern Greek,8,18,26,9,47,56,17,65,82
2023,Non-medical Healthcare Professions/Therapies,2907,14612,17519,249,868,1117,3156,15480,18636
2023,Low German,3,4,7,,,,3,4,7
2023,Dutch,80,142,222,12,21,33,92,163,255
2023,"Nordic/Scand. St. (Nord. Phil., ind. lang. n.e.c.)",258,647,905,21,38,59,279,685,964
2023,Optoelectronics,238,95,333,80,39,119,318,134,452
2023,Orchestral Music,283,282,565,501,630,1131,784,912,1696
2023,"Oriental Studies, Ancient Oriental Studies",332,457,789,109,121,230,441,578,1019
2023,MINT orientation studies,4,11,15,1,,1,5,11,16
2023,Eastern and South Eastern Europe Studies,107,185,292,37,70,107,144,255,399
2023,Oceanography,3,3,6,5,3,8,8,6,14
2023,Early Childhood Education,420,3103,3523,24,242,266,444,3345,3789
2023,Plant Production,331,311,642,28,22,50,359,333,692
2023,Nursing Science/Nursing Management,3184,9791,12975,207,624,831,3391,10415,13806
2023,Pharmacy,3794,9026,12820,908,2065,2973,4702,11091,15793
2023,Philosophy,8409,7024,15433,1186,1064,2250,9595,8088,17683
2023,Physics,25823,9801,35624,5951,2965,8916,31774,12766,44540
2023,Engineering Physics/Mechanical Process Engineering,1458,417,1875,728,182,910,2186,599,2785
2023,Political Science,14545,12240,26785,2153,2849,5002,16698,15089,31787
2023,Police/Protection of the Constitution,15929,9855,25784,259,151,410,16188,10006,26194
2023,Polish,9,21,30,4,14,18,13,35,48
2023,Portuguese,26,29,55,9,22,31,35,51,86
2023,Psychology,24722,79770,104492,2033,7307,9340,26755,87077,113832
2023,Spatial Planning,2441,2417,4858,529,889,1418,2970,3306,6276
2023,Administration of Justice,633,2350,2983,1,2,3,634,2352,2986
2023,Law,44262,61119,105381,3115,6019,9134,47377,67138,114515
2023,Renewable Energy,2065,642,2707,1042,253,1295,3107,895,4002
2023,Religious Studies,395,705,1100,141,176,317,536,881,1417
2023,Restoration Studies,130,584,714,13,46,59,143,630,773
2023,Rhythmics,1,8,9,1,12,13,2,20,22
2023,"Romance Studies (Rom. Phil., indiv. lang. n.e.c.)",418,1338,1756,155,493,648,573,1831,2404
2023,Russian,129,241,370,22,120,142,151,361,512
2023,General Studies (including School Garden),203,1011,1214,13,38,51,216,1049,1265
2023,Drama Studies,246,286,532,68,104,172,314,390,704
2023,Naval Architecture/Ship Technology,499,102,601,215,45,260,714,147,861
2023,School Pedagogy,142,262,404,23,35,58,165,297,462
2023,Sinology/Korean Studies,667,1529,2196,202,524,726,869,2053,2922
2023,Slavic Studies (Slavic Philology),285,563,848,141,348,489,426,911,1337
2023,Special Needs Education,3098,14677,17775,60,322,382,3158,14999,18157
2023,Other subjects,1084,1717,2801,721,969,1690,1805,2686,4491
2023,Other regional studies,113,206,319,33,135,168,146,341,487
2023,Other orientation studies,45,24,69,15,5,20,60,29,89
2023,Sorabistics,5,13,18,1,4,5,6,17,23
2023,Social Work,18063,61308,79371,1146,3888,5034,19209,65196,84405
2023,Social Studies,1820,1872,3692,102,114,216,1922,1986,3908
2023,Social Pedagogy,2205,9909,12114,77,489,566,2282,10398,12680
2023,Social Security Administration,803,1849,2652,56,68,124,859,1917,2776
2023,Applied Social Science,5408,17122,22530,340,1004,1344,5748,18126,23874
2023,Social Sciences,7408,10957,18365,930,1644,2574,8338,12601,20939
2023,Sociology,5491,11003,16494,632,1487,2119,6123,12490,18613
2023,Spanish,885,2409,3294,191,544,735,1076,2953,4029
2023,Sports Management/Sports Economics,7377,2653,10030,539,148,687,7916,2801,10717
2023,Sports Education/Sports Psychology,5650,3702,9352,182,97,279,5832,3799,9631
2023,Sports Science,12335,7747,20082,903,631,1534,13238,8378,21616
2023,Steel Construction,27,2,29,4,1,5,31,3,34
2023,Statistics,2077,970,3047,1211,722,1933,3288,1692,4980
2023,"South Slavic (Bulgar., Serbo-Croat., Slovene etc.)",3,4,7,,1,1,3,5,8
2023,Dance Education,34,134,168,62,144,206,96,278,374
2023,Technical Cybernetics,236,69,305,36,17,53,272,86,358
2023,Technomathematics,1680,537,2217,434,239,673,2114,776,2890
2023,Textile Design,642,2027,2669,89,417,506,731,2444,3175
2023,Textile and Clothing Technology/Industry,420,1404,1824,320,259,579,740,1663,2403
2023,Theatre Studies,662,1886,2548,83,263,346,745,2149,2894
2023,Veterinary Medicine,938,6209,7147,155,535,690,1093,6744,7837
2023,Animal Production,61,152,213,16,15,31,77,167,244
2023,Sound Engineering,357,53,410,95,18,113,452,71,523
2023,Tourism Management,1882,5982,7864,426,879,1305,2308,6861,9169
2023,Transport and Conveying Technology,266,30,296,24,6,30,290,36,326
2023,Czech,4,9,13,5,12,17,9,21,30
2023,Turkish Studies,55,196,251,46,82,128,101,278,379
2023,Environmental Protection,780,975,1755,583,459,1042,1363,1434,2797
2023,Environmental Technology (including Recycling),3438,2273,5711,738,663,1401,4176,2936,7112
2023,Prehistory and Early History,400,464,864,37,63,100,437,527,964
2023,Process Engineering,3910,2480,6390,1220,974,2194,5130,3454,8584
2023,Transport Engineering,2727,724,3451,962,301,1263,3689,1025,4714
2023,Transport Economics,797,338,1135,238,163,401,1035,501,1536
2023,Surveying (Geodesy),2686,1052,3738,865,433,1298,3551,1485,5036
2023,Supply Technology,2346,398,2744,352,84,436,2698,482,3180
2023,Administrative Science/Public Administration,7689,10932,18621,331,332,663,8020,11264,19284
2023,Folklore,225,628,853,24,103,127,249,731,980
2023,Economics,10045,4248,14293,2914,2890,5804,12959,7138,20097
2023,Hydraulic Engineering,490,353,843,220,154,374,710,507,1217
2023,Water Management,423,250,673,319,190,509,742,440,1182
2023,Viticulture and Oenology,539,313,852,102,114,216,641,427,1068
2023,Handicrafts (technical)/Technology,167,243,410,1,21,22,168,264,432
2023,Handicrafts Education,30,69,99,,2,2,30,71,101
2023,Materials Technology,1905,693,2598,1298,626,1924,3203,1319,4522
2023,Western Slavic (general and n.e.c.),12,16,28,3,3,6,15,19,34
2023,Economic/Social Geography,215,216,431,7,14,21,222,230,452
2023,Economic/Social History,91,70,161,17,38,55,108,108,216
2023,Business Informatics,45820,10920,56740,6843,4326,11169,52663,15246,67909
2023,Business Engineering spec. in Engineering Sciences,37693,9821,47514,9252,3929,13181,46945,13750,60695
2023,Business Engineering specialising in Economics,17755,5782,23537,2558,1231,3789,20313,7013,27326
2023,Business Mathematics,2681,1429,4110,608,739,1347,3289,2168,5457
2023,Business and Economics Education,2249,3422,5671,73,217,290,2322,3639,5961
2023,Business Law,7747,11891,19638,655,1243,1898,8402,13134,21536
2023,Business and Economics,40491,32247,72738,6719,7391,14110,47210,39638,86848
2023,History of Science/History of Technology,20,12,32,1,1,2,21,13,34
2023,Dentistry,4102,9266,13368,959,1331,2290,5061,10597,15658
2023,Customs and Tax Administration,2943,3248,6191,16,26,42,2959,3274,6233
2024,Waste Management,44,16,60,2,2,4,46,18,64
2024,African Studies,391,613,1004,127,169,296,518,782,1300
2024,Agricultural Biology,254,255,509,323,308,631,577,563,1140
2024,Agricultural Economics,625,414,1039,502,361,863,1127,775,1902
2024,Agricultural Science/Agriculture,5810,5349,11159,1288,1253,2541,7098,6602,13700
2024,Egyptology,303,382,685,27,46,73,330,428,758
2024,General Linguistics/Indo-European Studies,988,2821,3809,409,996,1405,1397,3817,5214
2024,General Literary Studies,749,3126,3875,156,506,662,905,3632,4537
2024,Ancient History,98,84,182,26,18,44,124,102,226
2024,American Studies,582,1330,1912,484,830,1314,1066,2160,3226
2024,Applied Art,1204,2478,3682,140,383,523,1344,2861,4205
2024,Applied Linguistics,802,2606,3408,231,747,978,1033,3353,4386
2024,Applied Systems Science,1538,447,1985,1390,442,1832,2928,889,3817
2024,English Studies,12382,29769,42151,1581,4329,5910,13963,34098,48061
2024,Anthropology (Human Biology),76,329,405,65,173,238,141,502,643
2024,Arabic/Arabic Studies,111,238,349,71,81,152,182,319,501
2024,Work Studies/Business Studies,691,950,1641,29,58,87,720,1008,1728
2024,Occupational Guidance and Career Counselling,195,434,629,5,7,12,200,441,641
2024,Labour Administration,315,610,925,6,7,13,321,617,938
2024,Archaeology,2474,3055,5529,211,347,558,2685,3402,6087
2024,Archaeometry (Archaeological Engineering),19,9,28,1,1,2,20,10,30
2024,Architecture,13825,20130,33955,2708,4526,7234,16533,24656,41189
2024,Archive and Documentation Science,57,71,128,9,13,22,66,84,150
2024,Archive Studies,151,200,351,1,4,5,152,204,356
2024,Asian Languages and Cultures/Asian Studies,378,848,1226,238,448,686,616,1296,1912
2024,Astrophysics and Astronomy,209,91,300,280,138,418,489,229,718
2024,Ophthalmic Optics,199,499,698,31,70,101,230,569,799
2024,Immigrant Education,22,85,107,28,51,79,50,136,186
2024,Non-Europ. Lang. and Cult. in Oceania and America,36,59,95,22,44,66,58,103,161
2024,Foreign Affairs Administration,134,158,292,4,2,6,138,160,298
2024,Baltic Studies,1,3,4,,1,1,1,4,5
2024,Banking,393,257,650,36,36,72,429,293,722
2024,Civil Engineering/Structural Engineering,31364,13544,44908,8724,3668,12392,40088,17212,57300
2024,Mining/Mine Engineering,527,161,688,955,273,1228,1482,434,1916
2024,Occupation-specific Foreign Language Training,285,598,883,99,163,262,384,761,1145
2024,"Vocational, Business and Economics Education",748,1691,2439,115,136,251,863,1827,2690
2024,Business Administration,105911,88740,194651,17332,17770,35102,123243,106510,229753
2024,Librarianship,14,50,64,,,,14,50,64
2024,Fine Arts/Graphics,1078,1643,2721,421,864,1285,1499,2507,4006
2024,Sculpting/Statuary Art,98,161,259,60,102,162,158,263,421
2024,Biochemistry,2769,4284,7053,692,1318,2010,3461,5602,9063
2024,Bioinformatics,1145,891,2036,445,535,980,1590,1426,3016
2024,Biology,15687,31482,47169,3165,6327,9492,18852,37809,56661
2024,Biomedicine,527,1700,2227,323,587,910,850,2287,3137
2024,Biotechnology,4011,5942,9953,1444,2154,3598,5455,8096,13551
2024,Brewing Science/Beverage Technology,319,111,430,48,19,67,367,130,497
2024,Armed Forces Administration,270,314,584,,,,270,314,584
2024,Byzantine Studies,2,8,10,17,12,29,19,20,39
2024,Caritas Science,25,44,69,11,8,19,36,52,88
2024,Chemistry,16994,12407,29401,3328,4072,7400,20322,16479,36801
2024,Chemical Engineering/Chemical Process Technology,3977,2239,6216,1188,939,2127,5165,3178,8343
2024,Computer Linguistics,631,539,1170,687,820,1507,1318,1359,2677
2024,Computer and Communication Technology,3198,2138,5336,1188,825,2013,4386,2963,7349
2024,Danish,17,48,65,,1,1,17,49,66
2024,Performing Arts/Stagecraft/Directing,379,933,1312,142,373,515,521,1306,1827
2024,German as a Foreign or Second Language,336,1882,2218,331,1045,1376,667,2927,3594
2024,Pastoral Care Studies,82,123,205,17,17,34,99,140,239
2024,Conducting,102,59,161,89,70,159,191,129,320
2024,Printing and Reproduction Technology,501,751,1252,102,108,210,603,859,1462
2024,Gemstone and Jewellery Design,9,44,53,8,51,59,17,95,112
2024,Electrical Power Engineering,856,152,1008,401,106,507,1257,258,1515
2024,Electrical Engineering/Electronics,32156,3992,36148,18738,5113,23851,50894,9105,59999
2024,Energy Process Engineering,2998,736,3734,1152,325,1477,4150,1061,5211
2024,Nutritional Science,1088,5008,6096,171,781,952,1259,5789,7048
2024,Adult Education and Extracurricular Youth Educat.,466,1542,2008,27,100,127,493,1642,2135
2024,Educational Science (Pedagogy),12079,42780,54859,743,3368,4111,12822,46148,58970
2024,Ethics,325,700,1025,39,71,110,364,771,1135
2024,Ethnology,697,1876,2573,271,499,770,968,2375,3343
2024,European Ethnology and Cultural Studies,668,2001,2669,180,400,580,848,2401,3249
2024,European Economic Studies,644,904,1548,216,238,454,860,1142,2002
2024,"Protestant Religious Pedagogy, Church Educat. Work",166,382,548,7,13,20,173,395,568
2024,"Protestant Theology, Protes. Religious Education",2752,4053,6805,283,206,489,3035,4259,7294
2024,Facility Management,1917,1391,3308,81,58,139,1998,1449,3447
2024,Automotive Technology,7027,576,7603,2758,287,3045,9785,863,10648
2024,Precision Engineering,425,51,476,76,7,83,501,58,559
2024,Manufacturing Technology/Production Engineering,2614,483,3097,1381,275,1656,3995,758,4753
2024,Film and Television Studies,1230,1114,2344,268,341,609,1498,1455,2953
2024,Financial Administration,981,1117,2098,3,9,12,984,1126,2110
2024,Finno-Ugrian Studies,39,60,99,5,9,14,44,69,113
2024,"Forest Science, Forestry",3616,2215,5831,401,370,771,4017,2585,6602
2024,French,718,2718,3436,152,396,548,870,3114,3984
2024,Horticulture,946,770,1716,62,76,138,1008,846,1854
2024,Geography,9607,10276,19883,651,736,1387,10258,11012,21270
2024,Geology/Palaeontology,149,131,280,63,50,113,212,181,393
2024,Geoecology,458,600,1058,58,91,149,516,691,1207
2024,Geophysics,612,560,1172,124,100,224,736,660,1396
2024,Geosciences general,4092,3274,7366,1153,799,1952,5245,4073,9318
2024,German Studies/German,12128,44923,57051,1103,3893,4996,13231,48816,62047
2024,Singing,257,450,707,311,430,741,568,880,1448
2024,History,16269,12275,28544,1266,1288,2554,17535,13563,31098
2024,Health Education,1323,5134,6457,66,264,330,1389,5398,6787
2024,Health Technology,4279,4626,8905,2118,2119,4237,6397,6745,13142
2024,Health Science/Health Management,8636,25051,33687,1162,2827,3989,9798,27878,37676
2024,Glass Technology/Ceramics,54,29,83,11,6,17,65,35,100
2024,Graphic Design/Communication Design,7285,15668,22953,1498,3431,4929,8783,19099,27882
2024,Greek,156,134,290,39,32,71,195,166,361
2024,Primary School Education/Primary Level Education,1950,8962,10912,40,218,258,1990,9180,11170
2024,Domestic and Nutritional Sciences,975,4251,5226,240,375,615,1215,4626,5841
2024,Domestic Science,22,88,110,1,,1,23,88,111
2024,Wood and Fibre Technology,522,112,634,25,9,34,547,121,668
2024,Timber Construction,505,104,609,13,3,16,518,107,625
2024,Wood Science,141,35,176,34,18,52,175,53,228
2024,Metallurgy and Foundry,211,46,257,114,41,155,325,87,412
2024,Indology,25,42,67,19,27,46,44,69,113
2024,Industrial Design/Product Design,1763,1785,3548,318,439,757,2081,2224,4305
2024,Computer Science,88886,18307,107193,32826,12453,45279,121712,30760,152472
2024,Inf./Library Scien. (not at univ. of app.adm.sci.),577,1893,2470,39,113,152,616,2006,2622
2024,Computational Engineer./Technical Computer Science,8669,1410,10079,4328,1450,5778,12997,2860,15857
2024,Interior Architecture,453,3586,4039,77,484,561,530,4070,4600
2024,Internal Administration,2398,4677,7075,15,37,52,2413,4714,7127
2024,Instrumental Music,1091,1010,2101,2161,2549,4710,3252,3559,6811
2024,Interdisc. Studies (specialising in Engineering),11124,4058,15182,4561,1623,6184,15685,5681,21366
2024,Interdisc. Studies (special. in Natural Sciences),3186,3475,6661,1791,1702,3493,4977,5177,10154
2024,"Interdisc. St. (spec. in Law, Econ. and Soc. Sci.)",6906,7889,14795,1398,2162,3560,8304,10051,18355
2024,Interdisc. Studies (spec. in Humanities),4795,10973,15768,1280,2841,4121,6075,13814,19889
2024,"Interdisc. Studies (special. in Art, Art Theory)",196,638,834,174,308,482,370,946,1316
2024,International Business Studies/Management,13901,17802,31703,8862,9326,18188,22763,27128,49891
2024,Iranian Studies,34,46,80,54,84,138,88,130,218
2024,Islamic Studies/Islamic theology,319,426,745,114,86,200,433,512,945
2024,Islamic Studies,243,523,766,114,126,240,357,649,1006
2024,Italian,165,405,570,66,219,285,231,624,855
2024,Japanese Studies,1131,1310,2441,116,241,357,1247,1551,2798
2024,Jazz and Popular Music,1008,371,1379,206,97,303,1214,468,1682
2024,Judaic Studies/Hebrew,147,187,334,48,74,122,195,261,456
2024,Law Enforcement,83,104,187,,,,83,104,187
2024,Cartography,83,89,172,53,75,128,136,164,300
2024,"Catholic Religious Pedagogy, Church Educat. Work",77,163,240,77,91,168,154,254,408
2024,"Catholic Theology, Catholic Religious Education",2086,2746,4832,394,131,525,2480,2877,5357
2024,Caucasian Studies,1,1,2,,2,2,1,3,4
2024,Church Music,263,109,372,37,49,86,300,158,458
2024,Classical Philology,109,162,271,19,27,46,128,189,317
2024,"Communication Technology, Information Engineering",3775,579,4354,2858,1103,3961,6633,1682,8315
2024,Communication Science/Journalism,4384,12101,16485,368,1141,1509,4752,13242,17994
2024,Composition,127,48,175,162,117,279,289,165,454
2024,Arts Education,1018,4951,5969,105,431,536,1123,5382,6505
2024,"Art History, Art Theory",1872,6893,8765,205,950,1155,2077,7843,9920
2024,Plastics Technology,366,90,456,61,18,79,427,108,535
2024,Land Management Engineering/Landscape Design,1885,2913,4798,144,265,409,2029,3178,5207
2024,Landscape Ecology/Biogeography (ex. SF385 s. 2012),500,751,1251,25,49,74,525,800,1325
2024,Latin,565,782,1347,32,28,60,597,810,1407
2024,Latin America Studies,79,170,249,42,87,129,121,257,378
2024,Food Chemistry,554,1070,1624,53,149,202,607,1219,1826
2024,Food Technology,1082,1430,2512,228,396,624,1310,1826,3136
2024,Area of study: Humanities,1388,7303,8691,34,176,210,1422,7479,8901
2024,Area of study: Social Studies,185,207,392,3,4,7,188,211,399
2024,Area of study: Natural Sciences/General Studies,1178,4583,5761,22,89,111,1200,4672,5872
2024,Area of study: Technology,508,161,669,10,4,14,518,165,683
2024,Aeronautical and Aerospace Engineering,5216,822,6038,1479,419,1898,6695,1241,7936
2024,Painting,198,354,552,56,131,187,254,485,739
2024,Mine Surveying,20,9,29,16,5,21,36,14,50
2024,Mechanical Engineering,51250,7389,58639,17347,3438,20785,68597,10827,79424
2024,Materials Engineering,912,366,1278,1187,419,1606,2099,785,2884
2024,Mathematics,22089,20369,42458,3948,2555,6503,26037,22924,48961
2024,Mechatronics,9225,1068,10293,5772,848,6620,14997,1916,16913
2024,Media Informatics,8630,5104,13734,1401,1096,2497,10031,6200,16231
2024,Media Technology,3772,2247,6019,520,300,820,4292,2547,6839
2024,Media Economics/Media Management,3392,6853,10245,375,817,1192,3767,7670,11437
2024,Media Science,3406,8871,12277,368,999,1367,3774,9870,13644
2024,Medicine (General Medicine),35584,67592,103176,5850,8890,14740,41434,76482,117916
2024,Medical Informatics,1276,1026,2302,556,657,1213,1832,1683,3515
2024,Metals Technology,351,57,408,5,3,8,356,60,416
2024,Meteorology,528,409,937,122,87,209,650,496,1146
2024,Microelectronics,40,5,45,318,154,472,358,159,517
2024,Microsystems Technology,877,179,1056,1077,293,1370,1954,472,2426
2024,Dairy Farming,29,18,47,3,13,16,32,31,63
2024,Mineralogy,67,50,117,34,35,69,101,85,186
2024,Medieval and Modern History,381,318,699,44,35,79,425,353,778
2024,Music Education,3191,3938,7129,318,616,934,3509,4554,8063
2024,Musicology/History of Music,1555,1868,3423,323,583,906,1878,2451,4329
2024,Nature Conservation,422,701,1123,174,188,362,596,889,1485
2024,Nautical Science/Maritime Studies,626,165,791,201,31,232,827,196,1023
2024,New Media,1056,1423,2479,263,398,661,1319,1821,3140
2024,Modern Greek,8,10,18,13,41,54,21,51,72
2024,Non-medical Healthcare Professions/Therapies,3256,16310,19566,292,976,1268,3548,17286,20834
2024,Low German,5,5,10,,,,5,5,10
2024,Dutch,73,138,211,9,21,30,82,159,241
2024,"Nordic/Scand. St. (Nord. Phil., ind. lang. n.e.c.)",243,649,892,22,44,66,265,693,958
2024,Optoelectronics,194,88,282,82,51,133,276,139,415
2024,Orchestral Music,308,296,604,546,693,1239,854,989,1843
2024,"Oriental Studies, Ancient Oriental Studies",320,483,803,121,110,231,441,593,1034
2024,MINT orientation studies,128,66,194,4,4,8,132,70,202
2024,Eastern and South Eastern Europe Studies,115,183,298,30,66,96,145,249,394
2024,Oceanography,4,4,8,7,1,8,11,5,16
2024,Early Childhood Education,452,3174,3626,38,282,320,490,3456,3946
2024,Plant Production,312,319,631,30,27,57,342,346,688
2024,Nursing Science/Nursing Management,3041,9727,12768,238,704,942,3279,10431,13710
2024,Pharmacy,3687,8992,12679,885,2201,3086,4572,11193,15765
2024,Philosophy,7934,6615,14549,1191,1094,2285,9125,7709,16834
2024,Physics,24917,9794,34711,6367,3239,9606,31284,13033,44317
2024,Engineering Physics/Mechanical Process Engineering,1380,412,1792,768,190,958,2148,602,2750
2024,Political Science,14307,12495,26802,2177,2993,5170,16484,15488,31972
2024,Police/Protection of the Constitution,15931,10111,26042,187,124,311,16118,10235,26353
2024,Polish,6,18,24,3,9,12,9,27,36
2024,Portuguese,17,27,44,11,18,29,28,45,73
2024,Psychology,24695,81985,106680,2059,7735,9794,26754,89720,116474
2024,Spatial Planning,2419,2450,4869,502,934,1436,2921,3384,6305
2024,Administration of Justice,681,2440,3121,,2,2,681,2442,3123
2024,Law,44008,61995,106003,3190,6079,9269,47198,68074,115272
2024,Renewable Energy,2071,634,2705,1074,292,1366,3145,926,4071
2024,Religious Studies,371,656,1027,151,160,311,522,816,1338
2024,Restoration Studies,142,600,742,7,46,53,149,646,795
2024,Rhythmics,,17,17,1,10,11,1,27,28
2024,"Romance Studies (Rom. Phil., indiv. lang. n.e.c.)",401,1231,1632,155,441,596,556,1672,2228
2024,Russian,116,218,334,19,120,139,135,338,473
2024,General Studies (including School Garden),304,1417,1721,9,53,62,313,1470,1783
2024,Drama Studies,263,302,565,70,112,182,333,414,747
2024,Naval Architecture/Ship Technology,464,99,563,200,41,241,664,140,804
2024,School Pedagogy,157,261,418,26,43,69,183,304,487
2024,Sinology/Korean Studies,605,1471,2076,198,487,685,803,1958,2761
2024,Slavic Studies (Slavic Philology),280,527,807,113,333,446,393,860,1253
2024,Special Needs Education,2996,13785,16781,77,312,389,3073,14097,17170
2024,Other subjects,944,1401,2345,764,964,1728,1708,2365,4073
2024,Other regional studies,114,198,312,39,130,169,153,328,481
2024,Other orientation studies,277,377,654,8,5,13,285,382,667
2024,Sorabistics,8,15,23,1,4,5,9,19,28
2024,Social Work,18343,61964,80307,1116,3888,5004,19459,65852,85311
2024,Social Studies,1754,1799,3553,93,98,191,1847,1897,3744
2024,Social Pedagogy,2129,9912,12041,98,516,614,2227,10428,12655
2024,Social Security Administration,892,1882,2774,63,74,137,955,1956,2911
2024,Applied Social Science,5293,17061,22354,329,1015,1344,5622,18076,23698
2024,Social Sciences,7109,10721,17830,887,1605,2492,7996,12326,20322
2024,Sociology,5230,10928,16158,634,1489,2123,5864,12417,18281
2024,Spanish,795,2190,2985,171,489,660,966,2679,3645
2024,Sports Management/Sports Economics,7280,2593,9873,427,137,564,7707,2730,10437
2024,Sports Education/Sports Psychology,5799,4215,10014,196,123,319,5995,4338,10333
2024,Sports Science,12612,7889,20501,953,649,1602,13565,8538,22103
2024,Steel Construction,16,1,17,2,2,4,18,3,21
2024,Statistics,2215,1011,3226,1384,817,2201,3599,1828,5427
2024,"South Slavic (Bulgar., Serbo-Croat., Slovene etc.)",3,4,7,,1,1,3,5,8
2024,Dance Education,33,134,167,53,138,191,86,272,358
2024,Technical Cybernetics,230,58,288,30,14,44,260,72,332
2024,Technomathematics,1659,526,2185,494,298,792,2153,824,2977
2024,Textile Design,639,1934,2573,87,414,501,726,2348,3074
2024,Textile and Clothing Technology/Industry,432,1237,1669,405,271,676,837,1508,2345
2024,Theatre Studies,642,1814,2456,94,252,346,736,2066,2802
2024,Veterinary Medicine,877,6275,7152,149,550,699,1026,6825,7851
2024,Animal Production,38,113,151,13,10,23,51,123,174
2024,Sound Engineering,357,56,413,131,21,152,488,77,565
2024,Tourism Management,1784,5602,7386,380,838,1218,2164,6440,8604
2024,Transport and Conveying Technology,213,24,237,18,9,27,231,33,264
2024,Czech,5,6,11,5,13,18,10,19,29
2024,Turkish Studies,60,174,234,58,74,132,118,248,366
2024,Environmental Protection,745,923,1668,600,506,1106,1345,1429,2774
2024,Environmental Technology (including Recycling),3163,2063,5226,740,647,1387,3903,2710,6613
2024,Prehistory and Early History,384,458,842,29,51,80,413,509,922
2024,Process Engineering,3681,2378,6059,1199,1008,2207,4880,3386,8266
2024,Transport Engineering,2592,663,3255,957,308,1265,3549,971,4520
2024,Transport Economics,745,323,1068,236,185,421,981,508,1489
2024,Surveying (Geodesy),2492,1010,3502,883,428,1311,3375,1438,4813
2024,Supply Technology,2221,385,2606,348,99,447,2569,484,3053
2024,Administrative Science/Public Administration,7505,10553,18058,372,348,720,7877,10901,18778
2024,Folklore,240,599,839,29,88,117,269,687,956
2024,Economics,10120,4316,14436,3546,3234,6780,13666,7550,21216
2024,Hydraulic Engineering,430,297,727,167,140,307,597,437,1034
2024,Water Management,398,244,642,334,190,524,732,434,1166
2024,Viticulture and Oenology,427,267,694,101,94,195,528,361,889
2024,Handicrafts (technical)/Technology,163,230,393,2,17,19,165,247,412
2024,Handicrafts Education,30,70,100,,1,1,30,71,101
2024,Materials Technology,1667,674,2341,1411,720,2131,3078,1394,4472
2024,Western Slavic (general and n.e.c.),10,13,23,4,4,8,14,17,31
2024,Economic/Social Geography,218,210,428,4,15,19,222,225,447
2024,Economic/Social History,81,61,142,19,32,51,100,93,193
2024,Business Informatics,45196,11377,56573,7535,4701,12236,52731,16078,68809
2024,Business Engineering spec. in Engineering Sciences,36969,9695,46664,9440,4057,13497,46409,13752,60161
2024,Business Engineering specialising in Economics,17371,5652,23023,2528,1121,3649,19899,6773,26672
2024,Business Mathematics,2499,1367,3866,623,669,1292,3122,2036,5158
2024,Business and Economics Education,2147,3257,5404,75,193,268,2222,3450,5672
2024,Business Law,7946,12304,20250,667,1266,1933,8613,13570,22183
2024,Business and Economics,39988,32720,72708,7502,7934,15436,47490,40654,88144
2024,History of Science/History of Technology,14,14,28,3,2,5,17,16,33
2024,Dentistry,4018,9461,13479,965,1322,2287,4983,10783,15766
2024,Customs and Tax Administration,2982,3106,6088,21,29,50,3003,3135,6138
